a	DT	a
a-horizon	NN	a-horizon
a-okay	JJ	a-okay
a-one	JJ	a-one
a-year	JJ	a-year
a.k.a.	RB	a.k.a.
contents	NNS	content
contents	VBZ	content
hairnets	NNS	hairnet
hairpiece	NN	hairpiece
hairpieces	NNS	hairpiece
hairpin	NN	hairpin
hairpins	NNS	hairpin
hairs	NNS	hair
hairsbreadth	NN	hairsbreadth
hairsbreadths	NNS	hairsbreadth
hairsplitter	NN	hairsplitter
hairsplitters	NNS	hairsplitter
hairsplitting	JJ	hairsplitting
hairsplitting	NN	hairsplitting
hairsplittings	NNS	hairsplitting
hairspray	NN	hairspray
hairsprays	NNS	hairspray
hairspring	NN	hairspring
hairsprings	NNS	hairspring
hairstreak	NN	hairstreak
hairstreaks	NNS	hairstreak
hairstyle	NN	hairstyle
hairstyles	NNS	hairstyle
hairstyling	NN	hairstyling
hairstylings	NNS	hairstyling
hairstylist	NN	hairstylist
hairstylists	NNS	hairstylist
hairtail	NN	hairtail
hairtonic	NN	hairtonic
hairtrigger	NNS	hair-trigger
hairweaver	NN	hairweaver
hairweavers	NNS	hairweaver
hairweaving	NN	hairweaving
hairweavings	NNS	hairweaving
hairwork	NN	hairwork
hairworks	NNS	hairwork
hairworm	NN	hairworm
hairworms	NNS	hairworm
hairy	JJ	hairy
hairy-faced	JJ	hairy-faced
haith	NN	haith
haiths	NNS	haith
haj	NN	haj
hajes	NNS	haj
hajes	NNS	hajis
haji	NN	haji
hajis	NN	hajis
hajis	NNS	haji
hajj	NN	hajj
hajjes	NNS	hajj
hajjes	NNS	hajjis
hajji	NN	hajji
hajjis	NN	hajjis
hajjis	NNS	hajji
haka	NN	haka
hakam	NN	hakam
hakams	NNS	hakam
hakas	NNS	haka
hake	NN	hake
hake	NNS	hake
hakea	NN	hakea
hakeem	NN	hakeem
hakeems	NNS	hakeem
hakes	NNS	hake
hakim	NN	hakim
hakims	NNS	hakim
hakka	NN	hakka
haku	NN	haku
hakus	NNS	haku
halacha	NN	halacha
halachas	NNS	halacha
halachic	JJ	halachic
halachist	NN	halachist
halachists	NNS	halachist
halakah	NN	halakah
halakahs	NNS	halakah
halakha	NN	halakha
halakhah	NN	halakhah
halakhahs	NNS	halakhah
halakhas	NNS	halakha
halakhist	NN	halakhist
halakhists	NNS	halakhist
halakist	NN	halakist
halakists	NNS	halakist
halal	JJ	halal
halal	NN	halal
halala	NN	halala
halalah	NN	halalah
halalahs	NNS	halalah
halalas	NNS	halala
halalling	NN	halalling
halalling	NNS	halalling
halals	NNS	halal
halation	NNN	halation
halations	NNS	halation
halavah	NN	halavah
halavahs	NNS	halavah
halazone	NN	halazone
halazones	NNS	halazone
halberd	NN	halberd
halberdier	NN	halberdier
halberdiers	NNS	halberdier
halberds	NNS	halberd
halbert	NN	halbert
halberts	NNS	halbert
halchidhoma	NN	halchidhoma
halcyon	JJ	halcyon
halcyon	NN	halcyon
haldea	NN	haldea
hale	JJ	hale
hale	VB	hale
hale	VBP	hale
haled	VBD	hale
haled	VBN	hale
haleness	NN	haleness
halenesses	NNS	haleness
halenia	NN	halenia
haler	NN	haler
haler	JJR	hale
halers	NNS	haler
hales	VBZ	hale
halesia	NN	halesia
halest	JJS	hale
half	DT	half
half	NN	half
half	PDT	half
half-American	JJ	half-American
half-Americanized	JJ	half-Americanized
half-Anglicized	JJ	half-Anglicized
half-Aristotelian	JJ	half-Aristotelian
half-Asian	JJ	half-Asian
half-Asiatic	JJ	half-Asiatic
half-Christian	JJ	half-Christian
half-Confederate	JJ	half-Confederate
half-Creole	JJ	half-Creole
half-Dacron	JJ	half-Dacron
half-Elizabethan	JJ	half-Elizabethan
half-English	JJ	half-English
half-French	JJ	half-French
half-German	JJ	half-German
half-Greek	JJ	half-Greek
half-Hessian	JJ	half-Hessian
half-Irish	JJ	half-Irish
half-Italian	JJ	half-Italian
half-Latinized	JJ	half-Latinized
half-Mexican	JJ	half-Mexican
half-Mohammedan	JJ	half-Mohammedan
half-Moslem	JJ	half-Moslem
half-Muhammadan	JJ	half-Muhammadan
half-Muslim	JJ	half-Muslim
half-Russian	JJ	half-Russian
half-Scottish	JJ	half-Scottish
half-Semitic	JJ	half-Semitic
half-Shakespearean	JJ	half-Shakespearean
half-Spanish	JJ	half-Spanish
half-a-crown	NN	half-a-crown
half-a-dollar	NN	half-a-dollar
half-abandoned	JJ	half-abandoned
half-accustomed	JJ	half-accustomed
half-acquainted	JJ	half-acquainted
half-acquiescent	JJ	half-acquiescent
half-acquiescently	RB	half-acquiescently
half-acre	NN	half-acre
half-addressed	JJ	half-addressed
half-admiring	JJ	half-admiring
half-admiringly	RB	half-admiringly
half-admitted	JJ	half-admitted
half-admittedly	RB	half-admittedly
half-adream	JJ	half-adream
half-affianced	JJ	half-affianced
half-afloat	JJ	half-afloat
half-afraid	JJ	half-afraid
half-agreed	JJ	half-agreed
half-alike	JJ	half-alike
half-alive	JJ	half-alive
half-altered	JJ	half-altered
half-and-half	JJ	half-and-half
half-and-half	NN	half-and-half
half-angrily	RB	half-angrily
half-angry	JJ	half-angry
half-annoyed	JJ	half-annoyed
half-annoying	JJ	half-annoying
half-annoyingly	RB	half-annoyingly
half-armed	JJ	half-armed
half-ashamed	JJ	half-ashamed
half-ashamedly	RB	half-ashamedly
half-asleep	JJ	half-asleep
half-assed	JJ	half-assed
half-awake	JJ	half-awake
harns	NNS	harn
haroseth	NN	haroseth
harp	NN	harp
harp	VB	harp
harp	VBP	harp
harped	VBD	harp
harped	VBN	harp
harper	NN	harper
harpers	NNS	harper
harpia	NN	harpia
harpies	NNS	harpy
harpin	NN	harpin
harping	NNN	harping
harping	VBG	harp
harpings	NNS	harping
harpins	NNS	harpin
harpist	NN	harpist
harpists	NNS	harpist
harpless	JJ	harpless
harplike	JJ	harplike
harpoon	NN	harpoon
harpoon	VB	harpoon
harpoon	VBP	harpoon
harpooned	VBD	harpoon
harpooned	VBN	harpoon
harpooneer	NN	harpooneer
harpooneers	NNS	harpooneer
harpooner	NN	harpooner
harpooners	NNS	harpooner
harpooning	VBG	harpoon
harpoonlike	JJ	harpoonlike
harpoons	NNS	harpoon
harpoons	VBZ	harpoon
harps	NNS	harp
harps	VBZ	harp
harpsichord	NN	harpsichord
harpsichordist	NN	harpsichordist
harpsichordists	NNS	harpsichordist
harpsichords	NNS	harpsichord
harpulla	NN	harpulla
harpullia	NN	harpullia
harpwise	RB	harpwise
harpy	NN	harpy
harpylike	JJ	harpylike
harquebus	NN	harquebus
harquebuses	NNS	harquebus
harquebusier	NN	harquebusier
harquebusiers	NNS	harquebusier
harridan	NN	harridan
harridans	NNS	harridan
harried	VBD	harry
harried	VBN	harry
harrier	NN	harrier
harriers	NNS	harrier
harries	VBZ	harry
harrisia	NN	harrisia
harrow	NN	harrow
harrow	VB	harrow
harrow	VBP	harrow
harrowed	VBD	harrow
harrowed	VBN	harrow
harrower	NN	harrower
harrowers	NNS	harrower
harrowing	JJ	harrowing
harrowing	VBG	harrow
harrowingly	RB	harrowingly
harrowment	NN	harrowment
harrows	NNS	harrow
harrows	VBZ	harrow
harry	VB	harry
harry	VBP	harry
harrying	VBG	harry
harsh	JJ	harsh
harshen	VB	harshen
harshen	VBP	harshen
harshened	VBD	harshen
harshened	VBN	harshen
harshening	VBG	harshen
harshens	VBZ	harshen
harsher	JJR	harsh
harshest	JJS	harsh
harshly	RB	harshly
harshness	NN	harshness
harshnesses	NNS	harshness
harslet	NN	harslet
harslets	NNS	harslet
hart	NN	hart
hart	NNS	hart
hartal	NN	hartal
hartals	NNS	hartal
hartebeest	NN	hartebeest
hartebeests	NNS	hartebeest
harts	NNS	hart
hartshorn	NN	hartshorn
hartshorns	NNS	hartshorn
harum-scarumness	NN	harum-scarumness
haruspex	NN	haruspex
haruspical	JJ	haruspical
haruspication	NNN	haruspication
haruspications	NNS	haruspication
haruspices	NNS	haruspex
haruspicies	NNS	haruspicy
haruspicy	NNN	haruspicy
harvest	NN	harvest
harvest	VB	harvest
harvest	VBP	harvest
harvest-lice	NN	harvest-lice
harvestabilities	NNS	harvestability
harvestability	NNN	harvestability
harvestable	JJ	harvestable
harvested	VBD	harvest
harvested	VBN	harvest
harvester	NN	harvester
harvesters	NNS	harvester
harvestfish	NN	harvestfish
harvestfish	NNS	harvestfish
harvesting	NNN	harvesting
harvesting	VBG	harvest
harvestless	JJ	harvestless
harvestman	NN	harvestman
harvestmen	NNS	harvestman
harvests	NNS	harvest
harvests	VBZ	harvest
harvesttime	NN	harvesttime
harvesttimes	NNS	harvesttime
has	VBZ	have
has-been	NN	has-been
has-beens	NNS	has-been
hasenpfeffer	NN	hasenpfeffer
hasenpfeffers	NNS	hasenpfeffer
hash	NN	hash
hash	VB	hash
hash	VBP	hash
hash-slinger	NN	hash-slinger
hashed	VBD	hash
hashed	VBN	hash
hasheesh	NN	hasheesh
hasheeshes	NNS	hasheesh
hasher	NN	hasher
hashes	NNS	hash
hashes	VBZ	hash
hashhead	NN	hashhead
hashheads	NNS	hashhead
hashing	NNN	hashing
hashing	VBG	hash
hashish	NN	hashish
hashishes	NNS	hashish
hashmark	NN	hashmark
hask	JJ	hask
hask	NN	hask
haslet	NN	haslet
haslets	NNS	haslet
haslock	NN	haslock
hasn	MD	have
hasn	VBZ	have
hasp	NN	hasp
hasps	NNS	hasp
hassar	NN	hassar
hassars	NNS	hassar
hassel	NN	hassel
hassels	NNS	hassel
hassenpfeffer	NN	hassenpfeffer
hassium	NN	hassium
hassiums	NNS	hassium
hassle	NNN	hassle
hassle	VB	hassle
hassle	VBP	hassle
hassled	VBD	hassle
hassled	VBN	hassle
hasslefree	JJ	hasslefree
hassles	NNS	hassle
hassles	VBZ	hassle
hassling	VBG	hassle
hassock	NN	hassock
hassocks	NNS	hassock
hast	VBZ	have
hastate	JJ	hastate
hastately	RB	hastately
haste	NNN	haste
haste	VB	haste
haste	VBP	haste
hasted	VBD	haste
hasted	VBN	haste
hasteful	JJ	hasteful
hastefully	RB	hastefully
hasteless	JJ	hasteless
hastelessness	NN	hastelessness
hasten	VB	hasten
hasten	VBP	hasten
hastened	VBD	hasten
hastened	VBN	hasten
hastener	NN	hastener
hasteners	NNS	hastener
hastening	JJ	hastening
hastening	VBG	hasten
hastens	VBZ	hasten
hastes	NNS	haste
hastes	VBZ	haste
hastier	JJR	hasty
hastiest	JJS	hasty
hastily	RB	hastily
hastiness	NN	hastiness
hastinesses	NNS	hastiness
hasting	NNN	hasting
hasting	VBG	haste
hastings	NNS	hasting
hasty	JJ	hasty
hat	NN	hat
hat	VB	hat
hat	VBP	hat
hatable	JJ	hatable
hatband	NN	hatband
hatbands	NNS	hatband
hatbox	NN	hatbox
hatboxes	NNS	hatbox
hatbrush	NN	hatbrush
hatbrushes	NNS	hatbrush
hatch	NN	hatch
hatch	VB	hatch
hatch	VBP	hatch
hatchabilities	NNS	hatchability
hatchability	NNN	hatchability
hatchable	JJ	hatchable
hatchback	NN	hatchback
hatchbacks	NNS	hatchback
hatcheck	JJ	hatcheck
hatcheck	NN	hatcheck
hatchecks	NNS	hatcheck
hatched	JJ	hatched
hatched	VBD	hatch
hatched	VBN	hatch
hatchel	VB	hatchel
hatchel	VBP	hatchel
hatcheled	VBD	hatchel
hatcheled	VBN	hatchel
hatcheling	VBG	hatchel
hatchelled	VBD	hatchel
hatchelled	VBN	hatchel
hatchelling	NNN	hatchelling
hatchelling	NNS	hatchelling
hatchelling	VBG	hatchel
hatchels	VBZ	hatchel
hatcher	NN	hatcher
hatcheries	NNS	hatchery
hatchers	NNS	hatcher
hatchery	NN	hatchery
hatches	NNS	hatch
hatches	VBZ	hatch
hatchet	NN	hatchet
hatchetfaced	JJ	hatchetfaced
hatchetfish	NN	hatchetfish
hatchetlike	JJ	hatchetlike
hatchetman	NN	hatchetman
hatchetmen	NNS	hatchetman
hatchets	NNS	hatchet
hatchettite	NN	hatchettite
hatching	JJ	hatching
hatching	NN	hatching
hatching	VBG	hatch
hatchings	NNS	hatching
hatchling	NN	hatchling
hatchling	NNS	hatchling
hatchment	NN	hatchment
hatchments	NNS	hatchment
hatchway	NN	hatchway
hatchways	NNS	hatchway
hate	NN	hate
hate	VB	hate
hate	VBP	hate
hateable	JJ	hateable
hated	VBD	hate
hated	VBN	hate
hateful	JJ	hateful
hatefully	RB	hatefully
hatefulness	NN	hatefulness
hatefulnesses	NNS	hatefulness
hateless	JJ	hateless
hatemonger	NN	hatemonger
hatemongering	NN	hatemongering
hatemongers	NNS	hatemonger
hater	NN	hater
haters	NNS	hater
hates	NNS	hate
hates	VBZ	hate
hatful	NN	hatful
hatfuls	NNS	hatful
hath	VBZ	have
hathpace	NN	hathpace
hating	VBG	hate
hatiora	NN	hatiora
hatless	JJ	hatless
hatlessness	NN	hatlessness
hatlike	JJ	hatlike
hatmaker	NN	hatmaker
hatmakers	NNS	hatmaker
hatpin	NN	hatpin
hatpins	NNS	hatpin
hatrack	NN	hatrack
hatracks	NNS	hatrack
hatred	NNN	hatred
hatreds	NNS	hatred
hats	NNS	hat
hats	VBZ	hat
hatstand	NN	hatstand
hatstands	NNS	hatstand
hatted	VBD	hat
hatted	VBN	hat
hatter	NN	hatter
hatteria	NN	hatteria
hatterias	NNS	hatteria
hatters	NNS	hatter
hatting	NNN	hatting
hatting	VBG	hat
hattings	NNS	hatting
hattock	NN	hattock
hattocks	NNS	hattock
haubergeon	NN	haubergeon
haubergeons	NNS	haubergeon
hauberk	NN	hauberk
hauberks	NNS	hauberk
haud	NN	haud
hauds	NNS	haud
hauerite	NN	hauerite
haugh	NN	haugh
haughs	NNS	haugh
haughtier	JJR	haughty
haughtiest	JJS	haughty
haughtily	RB	haughtily
haughtiness	NN	haughtiness
haughtinesses	NNS	haughtiness
haughty	JJ	haughty
haul	NN	haul
haul	VB	haul
haul	VBP	haul
haulage	NN	haulage
haulages	NNS	haulage
haulback	NN	haulback
hauld	NN	hauld
haulds	NNS	hauld
hauled	VBD	haul
hauled	VBN	haul
hauler	NN	hauler
haulers	NNS	hauler
haulier	NN	haulier
hauliers	NNS	haulier
hauling	NNN	hauling
hauling	VBG	haul
haulm	NN	haulm
haulmier	JJR	haulmy
haulmiest	JJS	haulmy
haulms	NNS	haulm
haulmy	JJ	haulmy
hauls	NNS	haul
hauls	VBZ	haul
haulyard	NN	haulyard
haulyards	NNS	haulyard
haunch	NN	haunch
haunched	JJ	haunched
haunches	NNS	haunch
haunchless	JJ	haunchless
haunt	NN	haunt
haunt	VB	haunt
haunt	VBP	haunt
haunted	JJ	haunted
haunted	VBD	haunt
haunted	VBN	haunt
haunter	NN	haunter
haunters	NNS	haunter
haunting	JJ	haunting
haunting	NNN	haunting
haunting	VBG	haunt
hauntingly	RB	hauntingly
hauntings	NNS	haunting
haunts	NNS	haunt
haunts	VBZ	haunt
hauriant	JJ	hauriant
hausen	NN	hausen
hausens	NNS	hausen
hausfrau	NN	hausfrau
hausfraus	NNS	hausfrau
hausmannite	NN	hausmannite
haussa	NN	haussa
haust	NN	haust
haustella	NNS	haustellum
haustellate	JJ	haustellate
haustellum	NN	haustellum
haustoria	NNS	haustorium
haustorial	JJ	haustorial
haustorium	NN	haustorium
hautbois	NN	hautbois
hautboy	NN	hautboy
hautboyist	NN	hautboyist
hautboys	NNS	hautboy
haute-piece	NN	haute-piece
hauteur	NN	hauteur
hauteurs	NNS	hauteur
hav	NN	hav
havarti	NN	havarti
havartis	NNS	havarti
havasupai	NN	havasupai
havdalah	NN	havdalah
havdalahs	NNS	havdalah
have	NN	have
have	VB	have
have	VBP	have
have-not	NN	have-not
have-nots	NNS	have-not
havelock	NN	havelock
havelocks	NNS	havelock
haven	NN	haven
haven	MD	have
haven	VBP	have
havenless	JJ	havenless
havens	NNS	haven
havenward	RB	havenward
haveour	NN	haveour
haveours	NNS	haveour
haverel	NN	haverel
haverels	NNS	haverel
havering	NN	havering
haverings	NNS	havering
havers	UH	havers
haversack	NN	haversack
haversacks	NNS	haversack
haversine	NN	haversine
haversines	NNS	haversine
haves	NNS	have
havildar	NN	havildar
havildars	NNS	havildar
having	NNN	having
having	VBG	have
havings	NNS	having
havior	NN	havior
haviors	NNS	havior
haviour	NN	haviour
haviours	NNS	haviour
havoc	NN	havoc
havocker	NN	havocker
havockers	NNS	havocker
havocs	NNS	havoc
haw	NN	haw
haw	UH	haw
haw	VB	haw
haw	VBP	haw
haw-haw	NN	haw-haw
haw-haw	UH	haw-haw
hawala	NN	hawala
hawbuck	NN	hawbuck
hawbuck	NNS	hawbuck
hawbucks	NNS	hawbuck
hawed	VBD	haw
hawed	VBN	haw
hawfinch	NN	hawfinch
hawfinches	NNS	hawfinch
hawing	VBG	haw
hawk	NN	hawk
hawk	VB	hawk
hawk	VBP	hawk
hawk-eyed	JJ	hawk-eyed
hawkbell	NN	hawkbell
hawkbells	NNS	hawkbell
hawkbill	NN	hawkbill
hawkbills	NNS	hawkbill
hawkbit	NN	hawkbit
hawkbits	NNS	hawkbit
hawked	VBD	hawk
hawked	VBN	hawk
hawker	NN	hawker
hawkers	NNS	hawker
hawkey	NN	hawkey
hawkeys	NNS	hawkey
hawkie	NN	hawkie
hawkies	NNS	hawkie
hawkies	NNS	hawky
hawking	NNN	hawking
hawking	VBG	hawk
hawkings	NNS	hawking
hawkish	JJ	hawkish
hawkishness	NN	hawkishness
hawkishnesses	NNS	hawkishness
hawklike	JJ	hawklike
hawkmoth	NN	hawkmoth
illmanneredness	NN	illmanneredness
illnature	NN	illnature
illness	NNN	illness
illnesses	NNS	illness
lactary	JJ	lactary
macroscale	NN	macroscale
mugginess	NN	mugginess
mugginesses	NNS	mugginess
mugging	NNN	mugging
mugging	VBG	mug
nabe	NN	nabe
nabes	NNS	nabe
nabes	NNS	nabis
nabis	NN	nabis
nabk	NN	nabk
nabks	NNS	nabk
nabla	NN	nabla
nablas	NNS	nabla
nabob	NN	nabob
naboberies	NNS	nabobery
nabobery	NN	nabobery
nabobess	NN	nabobess
nabobesses	NNS	nabobess
nabobical	JJ	nabobical
nabobically	RB	nabobically
nabobish	JJ	nabobish
nabobishly	RB	nabobishly
nabobism	NNN	nabobism
nabobisms	NNS	nabobism
nabobs	NNS	nabob
nabobship	NN	nabobship
naboom	NN	naboom
nabs	NN	nabs
nabs	VBZ	nab
nabses	NNS	nabs
nabu	NN	nabu
nabumetone	NN	nabumetone
nacarat	NN	nacarat
nacarats	NNS	nacarat
nacelle	NN	nacelle
nacelles	NNS	nacelle
nach	NN	nach
nache	NN	nache
naches	NNS	nache
naches	NNS	nach
nacho	NN	nacho
nachos	NNS	nacho
nacimiento	NN	nacimiento
nacket	NN	nacket
nackets	NNS	nacket
nacre	NN	nacre
nacred	JJ	nacred
nacreous	JJ	nacreous
nacres	NNS	nacre
nada	NN	nada
nadas	NNS	nada
nadir	NN	nadir
nadiral	JJ	nadiral
nadirs	NNS	nadir
nadolol	NN	nadolol
nae	JJ	nae
naemorhedus	NN	naemorhedus
naething	NN	naething
naethings	NNS	naething
naeve	NN	naeve
naeves	NNS	naeve
naevi	NNS	naevus
naevoid	JJ	naevoid
naevus	NN	naevus
nafcillin	NN	nafcillin
naffness	NN	naffness
nag	NN	nag
nag	VB	nag
nag	VBP	nag
naga	NN	naga
nagami	NN	nagami
nagana	NN	nagana
naganas	NNS	nagana
nagas	NNS	naga
nageia	NN	nageia
nagged	VBD	nag
nagged	VBN	nag
nagger	NN	nagger
naggers	NNS	nagger
naggier	JJR	naggy
naggiest	JJS	naggy
nagging	JJ	nagging
nagging	VBG	nag
naggingly	RB	naggingly
naggingness	NN	naggingness
naggish	JJ	naggish
naggy	JJ	naggy
nagi	NN	nagi
nagor	NN	nagor
nagors	NNS	nagor
nags	NNS	nag
nags	VBZ	nag
nagual	NN	nagual
nahal	NN	nahal
nahals	NNS	nahal
naiad	NN	naiad
naiadaceae	NN	naiadaceae
naiadales	NN	naiadales
naiades	NNS	naiad
naiads	NNS	naiad
naiant	JJ	naiant
naias	NN	naias
naif	JJ	naif
naif	NN	naif
naifs	NNS	naif
naik	NN	naik
naiki	NN	naiki
naiks	NNS	naik
nail	NN	nail
nail	VB	nail
nail	VBP	nail
nail-biting	NNN	nail-biting
nail-sick	JJ	nail-sick
nailbitingly	RB	nailbitingly
nailbrush	NN	nailbrush
nailbrushes	NNS	nailbrush
nailed	VBD	nail
nailed	VBN	nail
nailer	NN	nailer
naileries	NNS	nailery
nailers	NNS	nailer
nailery	NN	nailery
nailfile	NN	nailfile
nailfold	NN	nailfold
nailfolds	NNS	nailfold
nailhead	NN	nailhead
nailheads	NNS	nailhead
nailing	NNN	nailing
nailing	VBG	nail
nailings	NNS	nailing
nailless	JJ	nailless
naillike	JJ	naillike
nailrod	NN	nailrod
nails	NNS	nail
nails	VBZ	nail
nailset	NN	nailset
nailsets	NNS	nailset
nailsickness	NN	nailsickness
nainsook	NN	nainsook
nainsooks	NNS	nainsook
naira	NN	naira
nairas	NNS	naira
naiskos	NN	naiskos
naissant	JJ	naissant
naive	JJ	naive
naive	NN	naive
naively	RB	naively
naiveness	NN	naiveness
naivenesses	NNS	naiveness
naiver	JJR	naive
naives	NNS	naive
naives	NNS	naif
naivest	JJS	naive
naivete	NN	naivete
naivetes	NNS	naivete
naiveties	NNS	naivety
naivetivet	NN	naivetivet
naivety	NN	naivety
naja	NN	naja
najadaceae	NN	najadaceae
najas	NN	najas
naked	JJ	naked
nakeder	JJR	naked
nakedest	JJS	naked
nakedly	RB	nakedly
nakedness	NN	nakedness
nakednesses	NNS	nakedness
nakedwood	NN	nakedwood
naker	NN	naker
nakers	NNS	naker
nala	NN	nala
nalas	NNS	nala
naled	NN	naled
naleds	NNS	naled
nalfon	NN	nalfon
nalidixic	JJ	nalidixic
nallah	NN	nallah
nallahs	NNS	nallah
nalorphine	NN	nalorphine
nalorphines	NNS	nalorphine
naloxone	NN	naloxone
naloxones	NNS	naloxone
naltrexone	NN	naltrexone
naltrexones	NNS	naltrexone
namability	NNN	namability
namaskar	NN	namaskar
namaskars	NNS	namaskar
namaste	NN	namaste
namastes	NNS	namaste
namaycush	NN	namaycush
namby-pambiness	NN	namby-pambiness
namby-pamby	JJ	namby-pamby
namby-pamby	NN	namby-pamby
namby-pambyish	JJ	namby-pambyish
namby-pambyism	NNN	namby-pambyism
name	NN	name
name	VB	name
name	VBP	name
name-caller	NN	name-caller
name-calling	NNN	name-calling
name-dropper	NN	name-dropper
name-dropping	NN	name-dropping
nameability	NNN	nameability
nameable	JJ	nameable
named	VBD	name
named	VBN	name
namedrop	VB	namedrop
namedrop	VBP	namedrop
namedropped	VBD	namedrop
namedropped	VBN	namedrop
namedropper	NN	namedropper
namedroppers	NNS	namedropper
namedropping	NN	namedropping
namedropping	VBG	namedrop
namedroppings	NNS	namedropping
namedrops	VBZ	namedrop
nameko	NN	nameko
nameless	JJ	nameless
namelessly	RB	namelessly
namelessness	NN	namelessness
namelessnesses	NNS	namelessness
namely	RB	namely
nameplate	NN	nameplate
nameplates	NNS	nameplate
namer	NN	namer
namers	NNS	namer
names	NNS	name
names	VBZ	name
namesake	NN	namesake
namesakes	NNS	namesake
nametag	NN	nametag
nametags	NNS	nametag
nametape	NN	nametape
nametapes	NNS	nametape
namibian	JJ	namibian
naming	NNN	naming
naming	VBG	name
namings	NNS	naming
namma	NN	namma
nammad	NN	nammad
namtaru	NN	namtaru
nan	NN	nan
nana	NN	nana
nanako	NN	nanako
nanas	NNS	nana
nance	NN	nance
nancere	NN	nancere
nances	NNS	nance
nancies	NNS	nancy
nancy	NN	nancy
nancys	NNS	nancy
nandin	NN	nandin
nandina	NN	nandina
nandinas	NNS	nandina
nandine	NN	nandine
nandines	NNS	nandine
nandins	NNS	nandin
nandoo	NN	nandoo
nandoos	NNS	nandoo
nandrolone	NN	nandrolone
nandu	NN	nandu
nanism	NNN	nanism
nanisms	NNS	nanism
nanjing	NN	nanjing
nankeen	NN	nankeen
nankeens	NNS	nankeen
nankin	NN	nankin
nankins	NNS	nankin
nanna	NN	nanna
nannas	NNS	nanna
nannies	NNS	nanny
nannofossil	NN	nannofossil
nannofossils	NNS	nannofossil
nannoplankton	NN	nannoplankton
nannoplanktons	NNS	nannoplankton
nanny	NN	nanny
nanny-goat	NN	nanny-goat
nannyberry	NN	nannyberry
nannygai	NN	nannygai
nannygais	NNS	nannygai
nanobot	NN	nanobot
nanobots	NNS	nanobot
nanocephalic	JJ	nanocephalic
nanocephaly	NN	nanocephaly
nanocurie	NN	nanocurie
nanoelectronic	JJ	nanoelectronic
nanofossil	NN	nanofossil
nanofossils	NNS	nanofossil
nanogram	NN	nanogram
nanograms	NNS	nanogram
nanoid	JJ	nanoid
nanometer	NN	nanometer
nanometers	NNS	nanometer
nanometre	NN	nanometre
nanometres	NNS	nanometre
nanomia	NN	nanomia
nanoplankton	NN	nanoplankton
nanoplanktons	NNS	nanoplankton
nanosecond	NN	nanosecond
nanoseconds	NNS	nanosecond
nanotechnologies	NNS	nanotechnology
nanotechnology	NNN	nanotechnology
nanotesla	NN	nanotesla
nanoteslas	NNS	nanotesla
nanowatt	NN	nanowatt
nanowatts	NNS	nanowatt
nans	NNS	nan
nantua	NN	nantua
naos	NN	naos
naoses	NNS	naos
naovely	RB	naovely
nap	NNN	nap
nap	VB	nap
nap	VBP	nap
napa	NN	napa
napaea	NN	napaea
napalm	NN	napalm
napalm	VB	napalm
napalm	VBP	napalm
napalmed	VBD	napalm
napalmed	VBN	napalm
napalming	VBG	napalm
napalms	NNS	napalm
napalms	VBZ	napalm
napas	NNS	napa
nape	NN	nape
napea	NN	napea
naperies	NNS	napery
napery	NN	napery
napes	NNS	nape
naphtha	NN	naphtha
naphthalene	NN	naphthalene
naphthalenes	NNS	naphthalene
naphthalic	JJ	naphthalic
naphthalin	NN	naphthalin
naphthaline	NN	naphthaline
naphthalines	NNS	naphthaline
naphthalins	NNS	naphthalin
naphthas	NNS	naphtha
naphthene	NN	naphthene
naphthenes	NNS	naphthene
naphthenic	JJ	naphthenic
naphthol	NN	naphthol
naphthols	NNS	naphthol
naphthoquinone	NN	naphthoquinone
naphthous	JJ	naphthous
naphthyl	NN	naphthyl
naphthylamine	NN	naphthylamine
naphthylamines	NNS	naphthylamine
naphthyls	NNS	naphthyl
naphtol	NN	naphtol
naphtols	NNS	naphtol
napiform	JJ	napiform
napkin	NN	napkin
napkins	NNS	napkin
napless	JJ	napless
naplessness	NN	naplessness
napoleon	NN	napoleon
napoleons	NNS	napoleon
nappa	NN	nappa
nappas	NNS	nappa
nappe	NN	nappe
napped	VBD	nap
napped	VBN	nap
napper	NN	napper
nappers	NNS	napper
nappie	JJ	nappie
nappie	NN	nappie
nappier	JJR	nappie
nappier	JJR	nappy
nappies	NNS	nappie
nappies	NNS	nappy
nappiest	JJS	nappie
nappiest	JJS	nappy
nappiness	NN	nappiness
nappinesses	NNS	nappiness
napping	VBG	nap
nappy	JJ	nappy
nappy	NN	nappy
naprapath	NN	naprapath
naprapathies	NNS	naprapathy
naprapathy	NN	naprapathy
naprosyn	NN	naprosyn
naproxen	NN	naproxen
naproxens	NNS	naproxen
naps	NNS	nap
naps	VBZ	nap
naptime	NN	naptime
naptimes	NNS	naptime
napu	NN	napu
naranjilla	NN	naranjilla
narc	NN	narc
narcein	NN	narcein
narceine	NN	narceine
narceines	NNS	narceine
narceins	NNS	narcein
narcism	NNN	narcism
narcisms	NNS	narcism
narcissi	NNS	narcissus
narcissism	NN	narcissism
narcissisms	NNS	narcissism
narcissist	NN	narcissist
narcissistic	JJ	narcissistic
narcissistically	RB	narcissistically
narcissists	NNS	narcissist
narcissus	NN	narcissus
narcissus	NNS	narcissus
narcissuses	NNS	narcissus
narcist	NN	narcist
narcistic	JJ	narcistic
narcists	NNS	narcist
narco	NN	narco
narcoanalyses	NNS	narcoanalysis
narcoanalysis	NN	narcoanalysis
narcolepsies	NNS	narcolepsy
narcolepsy	NN	narcolepsy
narcoleptic	JJ	narcoleptic
narcoleptic	NN	narcoleptic
narcoleptics	NNS	narcoleptic
narcoma	NN	narcoma
narcomania	NN	narcomania
narcomaniac	NN	narcomaniac
narcomaniacal	JJ	narcomaniacal
narcomas	NNS	narcoma
narcomatous	JJ	narcomatous
narcos	NN	narcos
narcos	NNS	narco
narcose	JJ	narcose
narcose	NN	narcose
narcoses	NNS	narcose
narcoses	NNS	narcos
narcoses	NNS	narcosis
narcosis	NN	narcosis
narcosyntheses	NNS	narcosynthesis
narcosynthesis	NN	narcosynthesis
narcotic	JJ	narcotic
narcotic	NN	narcotic
narcotically	RB	narcotically
narcoticalness	NN	narcoticalness
narcoticness	NN	narcoticness
narcotics	NNS	narcotic
narcotisation	NNN	narcotisation
narcotise	VB	narcotise
narcotise	VBP	narcotise
narcotised	VBD	narcotise
narcotised	VBN	narcotise
narcotises	VBZ	narcotise
narcotising	VBG	narcotise
narcotism	NNN	narcotism
narcotisms	NNS	narcotism
narcotist	NN	narcotist
narcotists	NNS	narcotist
narcotization	NN	narcotization
narcotizations	NNS	narcotization
narcotize	VB	narcotize
narcotize	VBP	narcotize
narcotized	JJ	narcotized
narcotized	VBD	narcotize
narcotized	VBN	narcotize
narcotizes	VBZ	narcotize
narcotizing	JJ	narcotizing
narcotizing	VBG	narcotize
narcs	NNS	narc
nard	NN	nard
nardine	JJ	nardine
nardo	NN	nardo
nardoo	NN	nardoo
nardoos	NNS	nardoo
nards	NNS	nard
nare	NN	nare
nares	NNS	nare
nares	NNS	naris
narghile	NN	narghile
narghiles	NNS	narghile
nargile	NN	nargile
nargileh	NN	nargileh
nargilehs	NNS	nargileh
nargiles	NNS	nargile
narial	JJ	narial
naricorn	NN	naricorn
naricorns	NNS	naricorn
naris	NN	naris
nark	NN	nark
nark	VB	nark
nark	VBP	nark
narked	VBD	nark
narked	VBN	nark
narkier	JJR	narky
narkiest	JJS	narky
narking	VBG	nark
narks	NNS	nark
narks	VBZ	nark
narky	JJ	narky
narras	NN	narras
narrases	NNS	narras
narratable	JJ	narratable
narrate	VB	narrate
narrate	VBP	narrate
narrated	VBD	narrate
narrated	VBN	narrate
narrater	NN	narrater
narraters	NNS	narrater
narrates	VBZ	narrate
narrating	VBG	narrate
narration	NNN	narration
narrations	NNS	narration
narrative	JJ	narrative
narrative	NNN	narrative
narratively	RB	narratively
narratives	NNS	narrative
narratologies	NNS	narratology
narratologist	NN	narratologist
narratologists	NNS	narratologist
narratology	NNN	narratology
narrator	NN	narrator
narrators	NNS	narrator
narrow	JJ	narrow
narrow	NN	narrow
narrow	VB	narrow
narrow	VBP	narrow
narrow-fisted	JJ	narrow-fisted
narrow-gage	JJ	narrow-gage
narrow-gauge	JJ	narrow-gauge
narrow-gauged	JJ	narrow-gauged
narrow-minded	JJ	narrow-minded
narrow-mindedly	RB	narrow-mindedly
narrow-mindedness	NN	narrow-mindedness
narrowboat	NN	narrowboat
narrowcasting	NN	narrowcasting
narrowcastings	NNS	narrowcasting
narrowed	JJ	narrowed
narrowed	VBD	narrow
narrowed	VBN	narrow
narrower	JJR	narrow
narrowest	JJS	narrow
narrowing	JJ	narrowing
narrowing	NNN	narrowing
narrowing	VBG	narrow
narrowings	NNS	narrowing
narrowly	RB	narrowly
narrowminded	JJ	narrow-minded
narrowmindedness	NNS	narrow-mindedness
narrowness	NN	narrowness
narrownesses	NNS	narrowness
narrows	NNS	narrow
narrows	VBZ	narrow
narthecal	JJ	narthecal
narthecium	NN	narthecium
narthex	NN	narthex
narthexes	NNS	narthex
nartjie	NN	nartjie
nartjies	NNS	nartjie
narwal	NN	narwal
narwals	NNS	narwal
narwhal	NN	narwhal
narwhale	NN	narwhale
narwhales	NNS	narwhale
narwhals	NNS	narwhal
nary	DT	nary
nary	JJ	nary
nasal	JJ	nasal
nasal	NN	nasal
nasale	VB	nasale
nasale	VBP	nasale
nasalis	NN	nasalis
nasalisation	NNN	nasalisation
nasalisations	NNS	nasalisation
nasalise	VB	nasalise
nasalise	VBP	nasalise
nasalised	VBD	nasalise
nasalised	VBN	nasalise
nasalises	VBZ	nasalise
nasalising	VBG	nasalise
nasalism	NNN	nasalism
nasalisms	NNS	nasalism
nasalities	NNS	nasality
nasality	NN	nasality
nasalization	NN	nasalization
nasalizations	NNS	nasalization
nasalize	VB	nasalize
nasalize	VBP	nasalize
nasalized	VBD	nasalize
nasalized	VBN	nasalize
nasalizes	VBZ	nasalize
nasalizing	VBG	nasalize
nasally	RB	nasally
nasals	NNS	nasal
nasard	NN	nasard
nasards	NNS	nasard
nascence	NN	nascence
nascences	NNS	nascence
nascencies	NNS	nascency
nascency	NN	nascency
nascent	JJ	nascent
nasdaq	NN	nasdaq
naseberries	NNS	naseberry
naseberry	NN	naseberry
nashgab	NN	nashgab
nashgabs	NNS	nashgab
nasial	JJ	nasial
nasion	NN	nasion
nasions	NNS	nasion
nasofrontal	JJ	nasofrontal
nasogastric	JJ	nasogastric
nasolacrimal	JJ	nasolacrimal
nasological	JJ	nasological
nasologist	NN	nasologist
nasology	NNN	nasology
nasopalatine	JJ	nasopalatine
nasopharyngeal	JJ	nasopharyngeal
nasopharynx	NN	nasopharynx
nasopharynxes	NNS	nasopharynx
nasotracheal	JJ	nasotracheal
nastier	JJR	nasty
nasties	NNS	nasty
nastiest	JJS	nasty
nastily	RB	nastily
nastiness	NN	nastiness
nastinesses	NNS	nastiness
nasturtium	NN	nasturtium
nasturtiums	NNS	nasturtium
nasty	JJ	nasty
nasty	NN	nasty
nasua	NN	nasua
nasute	NN	nasute
nasuteness	NN	nasuteness
nasutes	NNS	nasute
nat	NN	nat
natal	JJ	natal
natalities	NNS	natality
natality	NNN	natality
natant	JJ	natant
natantia	NN	natantia
natation	NNN	natation
natational	JJ	natational
natations	NNS	natation
natator	NN	natator
natatorial	JJ	natatorial
natatorium	NN	natatorium
natatoriums	NNS	natatorium
natatory	JJ	natatory
natch	JJ	natch
natch	NN	natch
natch	RB	natch
natches	NNS	natch
naticidae	NN	naticidae
nation	NN	nation
nation-state	NNN	nation-state
national	JJ	national
national	NN	national
nationalisation	NN	nationalisation
nationalisations	NNS	nationalisation
nationalise	VB	nationalise
nationalise	VBP	nationalise
nationalised	VBD	nationalise
nationalised	VBN	nationalise
nationaliser	NN	nationaliser
nationalises	VBZ	nationalise
nationalising	VBG	nationalise
nationalism	NN	nationalism
nationalisms	NNS	nationalism
nationalist	JJ	nationalist
nationalist	NN	nationalist
nationalistic	JJ	nationalistic
nationalistically	RB	nationalistically
nationalists	NNS	nationalist
nationalities	NNS	nationality
nationality	NNN	nationality
nationalization	NNN	nationalization
nationalizations	NNS	nationalization
nationalize	VB	nationalize
nationalize	VBP	nationalize
nationalized	VBD	nationalize
nationalized	VBN	nationalize
nationalizer	NN	nationalizer
nationalizers	NNS	nationalizer
nationalizes	VBZ	nationalize
nationalizing	VBG	nationalize
nationally	RB	nationally
nationals	NNS	national
nationhood	NN	nationhood
nationhoods	NNS	nationhood
nationless	JJ	nationless
nations	NNS	nation
nationstate	NNS	nation-state
nationstates	NNS	nation-state
nationwide	JJ	nationwide
nationwide	RB	nationwide
native	JJ	native
native	NN	native
native-born	JJ	native-born
nativeborn	JJ	native-born
natively	RB	natively
nativeness	NN	nativeness
nativenesses	NNS	nativeness
natives	NNS	native
nativism	NNN	nativism
nativisms	NNS	nativism
nativist	JJ	nativist
nativist	NN	nativist
nativistic	JJ	nativistic
nativists	NNS	nativist
nativities	NNS	nativity
nativity	NN	nativity
natl	NN	natl
natrium	NN	natrium
natriums	NNS	natrium
natriureses	NNS	natriuresis
natriuresis	NN	natriuresis
natriuretic	NN	natriuretic
natriuretics	NNS	natriuretic
natrix	NN	natrix
natrolite	NN	natrolite
natrolites	NNS	natrolite
natron	NN	natron
natrons	NNS	natron
nats	NNS	nat
natter	NN	natter
natter	VB	natter
natter	VBP	natter
nattered	VBD	natter
nattered	VBN	natter
natterer	NN	natterer
natterers	NNS	natterer
nattering	VBG	natter
natterjack	NN	natterjack
natterjacks	NNS	natterjack
natters	NNS	natter
natters	VBZ	natter
nattier	JJR	natty
nattiest	JJS	natty
nattily	RB	nattily
nattiness	NN	nattiness
nattinesses	NNS	nattiness
natty	JJ	natty
natural	JJ	natural
natural	NN	natural
natural-born	JJ	natural-born
naturalisation	NNN	naturalisation
naturalisations	NNS	naturalization
naturalise	VB	naturalise
naturalise	VBP	naturalise
naturalised	VBD	naturalise
naturalised	VBN	naturalise
naturaliser	NN	naturaliser
naturalises	VBZ	naturalise
naturalising	VBG	naturalise
naturalism	NN	naturalism
naturalisms	NNS	naturalism
naturalist	NN	naturalist
naturalistic	JJ	naturalistic
naturalistically	RB	naturalistically
naturalists	NNS	naturalist
naturalization	NN	naturalization
naturalizations	NNS	naturalization
naturalize	VB	naturalize
naturalize	VBP	naturalize
naturalized	VBD	naturalize
naturalized	VBN	naturalize
naturalizer	NN	naturalizer
naturalizers	NNS	naturalizer
naturalizes	VBZ	naturalize
naturalizing	VBG	naturalize
naturally	RB	naturally
naturalness	NN	naturalness
naturalnesses	NNS	naturalness
naturals	NNS	natural
nature	NNN	nature
naturedly	RB	naturedly
naturelike	JJ	naturelike
natures	NNS	nature
naturism	NNN	naturism
naturisms	NNS	naturism
naturist	NN	naturist
naturistic	JJ	naturistic
naturists	NNS	naturist
naturopath	NN	naturopath
naturopathic	JJ	naturopathic
naturopathies	NNS	naturopathy
naturopaths	NNS	naturopath
naturopathy	NN	naturopathy
nauch	NN	nauch
nauclea	NN	nauclea
naucrates	NN	naucrates
naught	NN	naught
naughtier	JJR	naughty
naughties	NNS	naughty
naughtiest	JJS	naughty
naughtily	RB	naughtily
naughtiness	NN	naughtiness
naughtinesses	NNS	naughtiness
naughts	NNS	naught
naughty	JJ	naughty
naughty	NN	naughty
naumachia	NN	naumachia
naumachias	NNS	naumachia
naumachies	NNS	naumachy
naumachy	NN	naumachy
naunt	NN	naunt
naunts	NNS	naunt
naupathia	NN	naupathia
nauplial	JJ	nauplial
naupliform	JJ	naupliform
nauplii	NNS	nauplius
nauplioid	JJ	nauplioid
nauplius	NN	nauplius
nauran	NN	nauran
nausea	NN	nausea
nauseant	NN	nauseant
nauseants	NNS	nauseant
nauseas	NNS	nausea
nauseate	VB	nauseate
nauseate	VBP	nauseate
nauseated	JJ	nauseated
nauseated	VBD	nauseate
nauseated	VBN	nauseate
nauseates	VBZ	nauseate
nauseating	JJ	nauseating
nauseating	VBG	nauseate
nauseatingly	RB	nauseatingly
nauseatingness	NN	nauseatingness
nauseation	NNN	nauseation
nauseations	NNS	nauseation
nauseous	JJ	nauseous
nauseously	RB	nauseously
nauseousness	NN	nauseousness
nauseousnesses	NNS	nauseousness
naut	NN	naut
nautch	NN	nautch
nautches	NNS	nautch
nautic	NN	nautic
nautical	JJ	nautical
nauticality	NNN	nauticality
nautically	RB	nautically
nautics	NNS	nautic
nautili	NNS	nautilus
nautilidae	NN	nautilidae
nautiloid	JJ	nautiloid
nautiloid	NN	nautiloid
nautiloids	NNS	nautiloid
nautilus	NN	nautilus
nautiluses	NNS	nautilus
nav	NN	nav
navaid	NN	navaid
navaids	NNS	navaid
navajo	NN	navajo
naval	JJ	naval
navally	RB	navally
navar	NN	navar
navarch	NN	navarch
navarchies	NNS	navarchy
navarchs	NNS	navarch
navarchy	NN	navarchy
navarin	NN	navarin
navarins	NNS	navarin
navars	NNS	navar
nave	NN	nave
navel	NN	navel
navels	NNS	navel
navelwort	NN	navelwort
navelworts	NNS	navelwort
naves	NNS	nave
navette	NN	navette
navettes	NNS	navette
navew	NN	navew
navews	NNS	navew
navicert	NN	navicert
navicerts	NNS	navicert
navicula	NN	navicula
navicular	JJ	navicular
navicular	NN	navicular
naviculars	NNS	navicular
naviculas	NNS	navicula
navies	NNS	navy
navig	NN	navig
navigabilities	NNS	navigability
navigability	NN	navigability
navigable	JJ	navigable
navigableness	NN	navigableness
navigablenesses	NNS	navigableness
navigably	RB	navigably
navigate	VB	navigate
navigate	VBP	navigate
navigated	VBD	navigate
navigated	VBN	navigate
navigates	VBZ	navigate
navigating	VBG	navigate
navigation	NN	navigation
navigational	JJ	navigational
navigationally	RB	navigationally
navigations	NNS	navigation
navigator	NN	navigator
navigators	NNS	navigator
navvies	NNS	navvy
navvy	NN	navvy
navy	JJ	navy
navy	NN	navy
nawab	NN	nawab
nawabs	NNS	nawab
nawabship	NN	nawabship
nay	JJ	nay
nay	NN	nay
nays	NNS	nay
naysayer	NN	naysayer
naysayers	NNS	naysayer
naysaying	NN	naysaying
naze	NN	naze
nazes	NNS	naze
nazes	NNS	nazis
nazi	NN	nazi
nazification	NNN	nazification
nazifications	NNS	nazification
naziism	NNN	naziism
nazir	NN	nazir
nazirs	NNS	nazir
nazis	NN	nazis
nazis	NNS	nazi
nazism	NNN	nazism
naïvely	RB	naïvely
naïveness	NNN	naïveness
ne	NN	ne
neafe	NN	neafe
neafes	NNS	neafe
neaffe	NN	neaffe
neaffes	NNS	neaffe
neandertal	JJ	neandertal
neanderthal	NN	neanderthal
neanderthaler	NN	neanderthaler
neanderthalers	NNS	neanderthaler
neanderthalian	JJ	neanderthalian
neanderthals	NNS	neanderthal
neap	JJ	neap
neap	NN	neap
neaped	JJ	neaped
neaps	NNS	neap
neaptide	NN	neaptide
neaptides	NNS	neaptide
near	IN	near
near	JJ	near
near	VB	near
near	VBP	near
near-blind	JJ	near-blind
near-normal	JJ	near-normal
near-point	NNN	near-point
near-sighted	JJ	near-sighted
near-sightedly	RB	near-sightedly
near-sightedness	NNN	near-sightedness
nearby	JJ	nearby
nearby	RB	nearby
neared	VBD	near
neared	VBN	near
nearer	JJR	near
nearest	IN	nearest
nearest	JJS	near
nearing	VBG	near
nearlier	JJR	nearly
nearliest	JJS	nearly
nearly	JJ	nearly
nearly	RB	nearly
nearness	NN	nearness
nearnesses	NNS	nearness
nears	VBZ	near
nearside	NN	nearside
nearsides	NNS	nearside
nearsighted	JJ	nearsighted
nearsightedness	NN	nearsightedness
nearsightednesses	NNS	nearsightedness
neat	JJ	neat
neat	NN	neat
neaten	VB	neaten
neaten	VBP	neaten
neatened	VBD	neaten
neatened	VBN	neaten
neatening	VBG	neaten
neatens	VBZ	neaten
neater	JJR	neat
neatest	JJS	neat
neath	IN	neath
neatherd	NN	neatherd
neatherds	NNS	neatherd
neatly	RB	neatly
neatness	NN	neatness
neatnesses	NNS	neatness
neb	NN	neb
nebbich	NN	nebbich
nebbiches	NNS	nebbich
nebbish	NN	nebbish
nebbishe	NN	nebbishe
nebbisher	NN	nebbisher
nebbishers	NNS	nebbisher
nebbishes	NNS	nebbishe
nebbishes	NNS	nebbish
nebbuk	NN	nebbuk
nebbuks	NNS	nebbuk
nebeck	NN	nebeck
nebecks	NNS	nebeck
nebek	NN	nebek
nebeks	NNS	nebek
nebel	NN	nebel
nebels	NNS	nebel
nebenkern	NN	nebenkern
nebenkerns	NNS	nebenkern
nebish	NN	nebish
nebishes	NNS	nebish
nebraskan	NN	nebraskan
nebris	NN	nebris
nebrises	NNS	nebris
nebs	NNS	neb
nebuchadnezzar	NN	nebuchadnezzar
nebuchadnezzars	NNS	nebuchadnezzar
nebula	NN	nebula
nebulae	NNS	nebula
nebular	JJ	nebular
nebulas	NNS	nebula
nebulated	JJ	nebulated
nebule	JJ	nebule
nebule	NN	nebule
nebules	NNS	nebule
nebulisation	NNN	nebulisation
nebuliser	NN	nebuliser
nebulisers	NNS	nebuliser
nebulization	NNN	nebulization
nebulizations	NNS	nebulization
nebulizer	NN	nebulizer
nebulizers	NNS	nebulizer
nebulose	JJ	nebulose
nebulosities	NNS	nebulosity
nebulosity	NNN	nebulosity
nebulosus	JJ	nebulosus
nebulous	JJ	nebulous
nebulously	RB	nebulously
nebulousness	NN	nebulousness
nebulousnesses	NNS	nebulousness
nebuly	RB	nebuly
necessarian	JJ	necessarian
necessarian	NN	necessarian
necessarianism	NNN	necessarianism
necessarians	NNS	necessarian
necessaries	NNS	necessary
necessarily	RB	necessarily
necessariness	NN	necessariness
necessary	JJ	necessary
necessary	NN	necessary
necessitarian	NN	necessitarian
necessitarianism	NNN	necessitarianism
necessitarianisms	NNS	necessitarianism
necessitarians	NNS	necessitarian
necessitate	VB	necessitate
necessitate	VBP	necessitate
necessitated	VBD	necessitate
necessitated	VBN	necessitate
necessitates	VBZ	necessitate
necessitating	VBG	necessitate
necessitation	NNN	necessitation
necessitations	NNS	necessitation
necessitative	JJ	necessitative
necessities	NNS	necessity
necessitous	JJ	necessitous
necessitously	RB	necessitously
necessitousness	NN	necessitousness
necessitousnesses	NNS	necessitousness
necessitude	NN	necessitude
necessity	NNN	necessity
neck	NN	neck
neck	VB	neck
neck	VBP	neck
neckband	NN	neckband
neckbands	NNS	neckband
neckcloth	NN	neckcloth
neckcloths	NNS	neckcloth
necked	JJ	necked
necked	VBD	neck
necked	VBN	neck
necker	NN	necker
neckerchief	NN	neckerchief
neckerchiefs	NNS	neckerchief
neckerchieves	NNS	neckerchief
neckers	NNS	necker
necking	NN	necking
necking	VBG	neck
neckings	NNS	necking
necklace	NN	necklace
necklace	VB	necklace
necklace	VBP	necklace
necklaced	VBD	necklace
necklaced	VBN	necklace
necklaces	NNS	necklace
necklaces	VBZ	necklace
necklacing	VBG	necklace
neckless	JJ	neckless
necklet	NN	necklet
necklets	NNS	necklet
necklike	JJ	necklike
neckline	NN	neckline
necklines	NNS	neckline
neckpiece	NN	neckpiece
neckpieces	NNS	neckpiece
necks	NNS	neck
necks	VBZ	neck
necktie	NN	necktie
necktieless	JJ	necktieless
neckties	NNS	necktie
neckwear	NN	neckwear
neckweed	NN	neckweed
neckweeds	NNS	neckweed
necremia	NN	necremia
necro	NN	necro
necrobacillosis	NN	necrobacillosis
necrobioses	NNS	necrobiosis
necrobiosis	NN	necrobiosis
necrographer	NN	necrographer
necrographers	NNS	necrographer
necrolatries	NNS	necrolatry
necrolatry	NN	necrolatry
necrologic	JJ	necrologic
necrological	JJ	necrological
necrologically	RB	necrologically
necrologies	NNS	necrology
necrologist	NN	necrologist
necrologists	NNS	necrologist
necrology	NN	necrology
necrolysis	NN	necrolysis
necromancer	NN	necromancer
necromancers	NNS	necromancer
necromancies	NNS	necromancy
necromancy	NN	necromancy
necromania	NN	necromania
necromantic	JJ	necromantic
necromantical	JJ	necromantical
necromantically	RB	necromantically
necromimesis	NN	necromimesis
necrophagia	NN	necrophagia
necrophagias	NNS	necrophagia
necrophagy	NN	necrophagy
necrophile	NN	necrophile
necrophiles	NNS	necrophile
necrophilia	NN	necrophilia
necrophiliac	JJ	necrophiliac
necrophiliac	NN	necrophiliac
necrophiliacs	NNS	necrophiliac
necrophilias	NNS	necrophilia
necrophilic	JJ	necrophilic
necrophilic	NN	necrophilic
necrophilism	NNN	necrophilism
necrophilisms	NNS	necrophilism
necrophobia	NN	necrophobia
necrophobias	NNS	necrophobia
necrophobic	JJ	necrophobic
necropoleis	NNS	necropolis
necropoles	NNS	necropolis
necropoli	NN	necropoli
necropoli	NNS	necropolis
necropolis	NN	necropolis
necropolis	NNS	necropoli
necropolises	NNS	necropolis
necropolitan	JJ	necropolitan
necropsies	NNS	necropsy
necropsy	NN	necropsy
necroscopies	NNS	necroscopy
necroscopy	NN	necroscopy
necrose	VB	necrose
necrose	VBP	necrose
necrosed	VBD	necrose
necrosed	VBN	necrose
necroses	VBZ	necrose
necroses	NNS	necrosis
necrosing	VBG	necrose
necrosis	NN	necrosis
necrotic	JJ	necrotic
necrotomic	JJ	necrotomic
necrotomies	NNS	necrotomy
necrotomist	NN	necrotomist
necrotomy	NN	necrotomy
nectar	NN	nectar
nectareous	JJ	nectareous
nectareously	RB	nectareously
nectareousness	NN	nectareousness
nectaries	NNS	nectary
nectariferous	JJ	nectariferous
nectarine	NN	nectarine
nectarines	NNS	nectarine
nectarous	JJ	nectarous
nectars	NNS	nectar
nectary	NN	nectary
nectocalyces	NNS	nectocalyx
nectocalyx	NN	nectocalyx
necturus	NN	necturus
ned	NN	ned
neddies	NNS	neddy
neddy	NN	neddy
neds	NNS	ned
nee	JJ	nee
need	MD	need
need	NNN	need
need	VB	need
need	VBP	need
needed	JJ	needed
needed	VBD	need
needed	VBN	need
needer	NN	needer
needers	NNS	needer
needfire	NN	needfire
needful	JJ	needful
needful	NN	needful
needfully	RB	needfully
needfulness	NN	needfulness
needfulnesses	NNS	needfulness
needfuls	NNS	needful
needier	JJR	needy
neediest	JJS	needy
needily	RB	needily
neediness	NN	neediness
needinesses	NNS	neediness
needing	VBG	need
needle	NN	needle
needle	VB	needle
needle	VBP	needle
needle-shaped	JJ	needle-shaped
needlebush	NN	needlebush
needlecord	NN	needlecord
needlecords	NNS	needlecord
needlecraft	NN	needlecraft
needlecrafts	NNS	needlecraft
needled	VBD	needle
needled	VBN	needle
needlefish	NN	needlefish
needlefish	NNS	needlefish
needleful	NN	needleful
needlefuls	NNS	needleful
needleless	JJ	needleless
needlelike	JJ	needlelike
needlepoint	NN	needlepoint
needlepoints	NNS	needlepoint
needler	NN	needler
needlers	NNS	needler
needles	NNS	needle
needles	VBZ	needle
needless	JJ	needless
needlessly	RB	needlessly
needlessness	NN	needlessness
needlessnesses	NNS	needlessness
needlewoman	NN	needlewoman
needlewomen	NNS	needlewoman
needlewood	NN	needlewood
needlework	NN	needlework
needleworker	NN	needleworker
needleworkers	NNS	needleworker
needleworks	NNS	needlework
needling	NNN	needling
needling	NNS	needling
needling	VBG	needle
needn	MD	need
needs	RB	needs
needs	NNS	need
needs	VBZ	need
needy	JJ	needy
neem	NN	neem
neems	NNS	neem
neencephalon	NN	neencephalon
neep	NN	neep
neeps	NNS	neep
nef	NN	nef
nefarious	JJ	nefarious
nefariously	RB	nefariously
nefariousness	NN	nefariousness
nefariousnesses	NNS	nefariousness
nefs	NNS	nef
neg	NN	neg
negaprion	NN	negaprion
negate	VB	negate
negate	VBP	negate
negated	VBD	negate
negated	VBN	negate
negatedness	NN	negatedness
negater	NN	negater
negaters	NNS	negater
negates	VBZ	negate
negating	NNN	negating
negating	VBG	negate
negation	NNN	negation
negational	JJ	negational
negationist	NN	negationist
negationists	NNS	negationist
negations	NNS	negation
negative	JJ	negative
negative	NNN	negative
negative	VB	negative
negative	VBG	negative
negative	VBP	negative
negative-raising	NNN	negative-raising
negatived	VBD	negative
negatived	VBN	negative
negatively	RB	negatively
negativeness	NN	negativeness
negativenesses	NNS	negativeness
negatives	NNS	negative
negatives	VBZ	negative
negativing	VBG	negative
negativism	NN	negativism
negativisms	NNS	negativism
negativist	NN	negativist
negativists	NNS	negativist
negativities	NNS	negativity
negativity	NN	negativity
negaton	NN	negaton
negatons	NNS	negaton
negator	NN	negator
negators	NNS	negator
negatron	NN	negatron
negatrons	NNS	negatron
neglect	NN	neglect
neglect	VB	neglect
neglect	VBP	neglect
neglected	JJ	neglected
neglected	VBD	neglect
neglected	VBN	neglect
neglectedly	RB	neglectedly
neglectedness	NN	neglectedness
neglecter	NN	neglecter
neglecters	NNS	neglecter
neglectful	JJ	neglectful
neglectfully	RB	neglectfully
neglectfulness	NN	neglectfulness
neglectfulnesses	NNS	neglectfulness
neglecting	VBG	neglect
neglectingly	RB	neglectingly
neglection	NNN	neglection
neglections	NNS	neglection
neglector	NN	neglector
neglectors	NNS	neglector
neglects	NNS	neglect
neglects	VBZ	neglect
neglige	NN	neglige
negligee	NNN	negligee
negligees	NNS	negligee
negligence	NN	negligence
negligences	NNS	negligence
negligent	JJ	negligent
negligently	RB	negligently
negliges	NNS	neglige
negligibilities	NNS	negligibility
negligibility	NNN	negligibility
negligible	JJ	negligible
negligibleness	NN	negligibleness
negligiblenesses	NNS	negligibleness
negligibly	RB	negligibly
negociant	NN	negociant
negociants	NNS	negociant
negociate	VB	negociate
negociate	VBP	negociate
negotiabilities	NNS	negotiability
negotiability	NN	negotiability
negotiable	JJ	negotiable
negotiable	NN	negotiable
negotiables	NNS	negotiable
negotiant	NN	negotiant
negotiants	NNS	negotiant
negotiate	VB	negotiate
negotiate	VBP	negotiate
negotiated	VBD	negotiate
negotiated	VBN	negotiate
negotiates	VBZ	negotiate
negotiating	VBG	negotiate
negotiation	NNN	negotiation
negotiations	NNS	negotiation
negotiator	NN	negotiator
negotiators	NNS	negotiator
negotiatress	NN	negotiatress
negotiatresses	NNS	negotiatress
negotiatrix	NN	negotiatrix
negotiatrixes	NNS	negotiatrix
negritude	NN	negritude
negritudes	NNS	negritude
negro	JJ	negro
negroid	JJ	negroid
negroid	NN	negroid
negroids	NNS	negroid
negroism	NNN	negroism
negroisms	NNS	negroism
negroni	NN	negroni
negronis	NNS	negroni
negrophil	NN	negrophil
negrophile	NN	negrophile
negrophiles	NNS	negrophile
negrophilism	NNN	negrophilism
negrophilisms	NNS	negrophilism
negrophilist	NN	negrophilist
negrophilists	NNS	negrophilist
negrophils	NNS	negrophil
negrophobe	NN	negrophobe
negrophobes	NNS	negrophobe
negrophobia	NN	negrophobia
negrophobias	NNS	negrophobia
negs	NNS	neg
negus	NN	negus
neguses	NNS	negus
neif	NN	neif
neifs	NNS	neif
neigh	NN	neigh
neigh	VB	neigh
neigh	VBP	neigh
neighbor	JJ	neighbor
neighbor	NN	neighbor
neighbor	VB	neighbor
neighbor	VBP	neighbor
neighbored	VBD	neighbor
neighbored	VBN	neighbor
neighborhood	NNN	neighborhood
neighborhoods	NNS	neighborhood
neighboring	JJ	neighboring
neighboring	VBG	neighbor
neighborless	JJ	neighborless
neighborliness	NN	neighborliness
neighborlinesses	NNS	neighborliness
neighborly	RB	neighborly
neighbors	NNS	neighbor
neighbors	VBZ	neighbor
neighbour	JJ	neighbour
neighbour	NN	neighbour
neighbour	VB	neighbour
neighbour	VBP	neighbour
neighboured	VBD	neighbour
neighboured	VBN	neighbour
neighbourhood	NN	neighbourhood
neighbourhoods	NNS	neighbourhood
neighbouring	JJ	neighbouring
neighbouring	VBG	neighbour
neighbourless	JJ	neighbourless
neighbourliness	NN	neighbourliness
neighbourly	RB	neighbourly
neighbours	NNS	neighbour
neighbours	VBZ	neighbour
neighed	VBD	neigh
neighed	VBN	neigh
neighing	VBG	neigh
neighs	NNS	neigh
neighs	VBZ	neigh
neisseria	NN	neisseria
neither	CC	neither
neither	DT	neither
neive	NN	neive
neives	NNS	neive
neives	NNS	neif
nek	NN	nek
nekton	NN	nekton
nektonic	JJ	nektonic
nektons	NNS	nekton
nellie	NN	nellie
nellies	NNS	nellie
nellies	NNS	nelly
nelly	NN	nelly
nelson	NN	nelson
nelsons	NNS	nelson
nelumbian	JJ	nelumbian
nelumbium	NN	nelumbium
nelumbiums	NNS	nelumbium
nelumbo	NN	nelumbo
nelumbonaceae	NN	nelumbonaceae
nelumbos	NNS	nelumbo
nema	NN	nema
nemas	NNS	nema
nemathecial	JJ	nemathecial
nemathecium	NN	nemathecium
nemathelminth	NN	nemathelminth
nemathelminths	NNS	nemathelminth
nematic	JJ	nematic
nematicide	NN	nematicide
nematicides	NNS	nematicide
nematocera	NN	nematocera
nematocide	NN	nematocide
nematocides	NNS	nematocide
nematocyst	NN	nematocyst
nematocystic	JJ	nematocystic
nematocysts	NNS	nematocyst
nematode	NN	nematode
nematodes	NNS	nematode
nematological	JJ	nematological
nematologies	NNS	nematology
nematologist	NN	nematologist
nematologists	NNS	nematologist
nematology	NNN	nematology
nemertean	JJ	nemertean
nemertean	NN	nemertean
nemerteans	NNS	nemertean
nemertina	NN	nemertina
nemertine	NN	nemertine
nemertines	NNS	nemertine
nemeses	NNS	nemesis
nemesia	NN	nemesia
nemesias	NNS	nemesia
nemesis	NN	nemesis
nemo	NN	nemo
nemophila	NN	nemophila
nemophilas	NNS	nemophila
nemoricole	JJ	nemoricole
nene	NN	nene
nenes	NNS	nene
nenets	NN	nenets
nentsi	NN	nentsi
nentsy	NN	nentsy
nenuphar	NN	nenuphar
nenuphars	NNS	nenuphar
neo	JJ	neo
neo-Plastic	JJ	neo-Plastic
neo-classicist	NN	neo-classicist
neo-orthodoxy	NN	neo-orthodoxy
neoanthropic	JJ	neoanthropic
neoarsphenamine	NN	neoarsphenamine
neoarsphenamines	NNS	neoarsphenamine
neoblast	NN	neoblast
neoblasts	NNS	neoblast
neoceratodus	NN	neoceratodus
neoclassic	JJ	neoclassic
neoclassic	NN	neoclassic
neoclassical	JJ	neoclassical
neoclassicism	NN	neoclassicism
neoclassicisms	NNS	neoclassicism
neoclassicist	JJ	neoclassicist
neoclassicist	NN	neoclassicist
neoclassicistic	JJ	neoclassicistic
neoclassicists	NNS	neoclassicist
neocolonial	JJ	neocolonial
neocolonialism	NN	neocolonialism
neocolonialisms	NNS	neocolonialism
neocolonialist	NN	neocolonialist
neocolonialists	NNS	neocolonialist
neocon	NN	neocon
neocons	NNS	neocon
neoconservatism	NNN	neoconservatism
neoconservatisms	NNS	neoconservatism
neoconservative	NN	neoconservative
neoconservatives	NNS	neoconservative
neocortex	NN	neocortex
neocortexes	NNS	neocortex
neocortical	JJ	neocortical
neocortices	NNS	neocortex
neodymium	NN	neodymium
neodymiums	NNS	neodymium
neoencephalon	NN	neoencephalon
neoexpressionism	NNN	neoexpressionism
neofascism	NNN	neofascism
neofascisms	NNS	neofascism
neofascist	NN	neofascist
neofascists	NNS	neofascist
neofiber	NN	neofiber
neoformation	NNN	neoformation
neoformative	JJ	neoformative
neogeneses	NNS	neogenesis
neogenesis	NN	neogenesis
neogrammarian	NN	neogrammarian
neogrammarians	NNS	neogrammarian
neohygrophorus	NN	neohygrophorus
neoimperialism	NNN	neoimperialism
neoimpressionism	NNN	neoimpressionism
neoimpressionisms	NNS	neoimpressionism
neoimpressionist	NN	neoimpressionist
neoimpressionists	NNS	neoimpressionist
neolentinus	NN	neolentinus
neoliberal	JJ	neoliberal
neoliberal	NN	neoliberal
neoliberalism	NNN	neoliberalism
neoliberalisms	NNS	neoliberalism
neoliberals	NNS	neoliberal
neolith	NN	neolith
neoliths	NNS	neolith
neologian	NN	neologian
neologians	NNS	neologian
neologic	JJ	neologic
neological	JJ	neological
neologically	RB	neologically
neologies	NNS	neology
neologism	NNN	neologism
neologisms	NNS	neologism
neologist	NN	neologist
neologistic	JJ	neologistic
neologistical	JJ	neologistical
neologists	NNS	neologist
neology	NNN	neology
neomorph	NN	neomorph
neomorphs	NNS	neomorph
neomycin	NN	neomycin
neomycins	NNS	neomycin
neomys	NN	neomys
neon	NN	neon
neonatal	JJ	neonatal
neonatally	RB	neonatally
neonate	NN	neonate
neonates	NNS	neonate
neonatologies	NNS	neonatology
neonatologist	NN	neonatologist
neonatologists	NNS	neonatologist
neonatology	NNN	neonatology
neonomian	NN	neonomian
neonomians	NNS	neonomian
neons	NNS	neon
neoorthodox	JJ	neoorthodox
neoorthodoxies	NNS	neoorthodoxy
neoorthodoxy	NN	neoorthodoxy
neopagan	NN	neopagan
neopagans	NNS	neopagan
neopallium	NN	neopallium
neophile	NN	neophile
neophiles	NNS	neophile
neophilia	NN	neophilia
neophiliac	NN	neophiliac
neophiliacs	NNS	neophiliac
neophilias	NNS	neophilia
neophron	NN	neophron
neophyte	NN	neophyte
neophytes	NNS	neophyte
neophytic	JJ	neophytic
neophytism	NNN	neophytism
neoplasia	NN	neoplasia
neoplasias	NNS	neoplasia
neoplasm	NN	neoplasm
neoplasms	NNS	neoplasm
neoplasticism	NNN	neoplasticism
neoplasticisms	NNS	neoplasticism
neoplasticist	NN	neoplasticist
neoplasticists	NNS	neoplasticist
neoplasties	NNS	neoplasty
neoplasty	NNN	neoplasty
neoplatonist	NN	neoplatonist
neoplatonists	NNS	neoplatonist
neopolitan	NN	neopolitan
neoprene	NN	neoprene
neoprenes	NNS	neoprene
neorealism	NNN	neorealism
neorealisms	NNS	neorealism
neorealist	NN	neorealist
neorealists	NNS	neorealist
neoromantic	JJ	neoromantic
neoromanticism	NNN	neoromanticism
neostigmine	NN	neostigmine
neostigmines	NNS	neostigmine
neotenies	NNS	neoteny
neotenous	JJ	neotenous
neoteny	NN	neoteny
neoteric	JJ	neoteric
neoteric	NN	neoteric
neoterics	NNS	neoteric
neoterism	NNN	neoterism
neoterist	NN	neoterist
neoterists	NNS	neoterist
neoterminal	JJ	neoterminal
neotoma	NN	neotoma
neotraditional	JJ	neotraditional
neotropical	JJ	neotropical
neotype	NN	neotype
neotypes	NNS	neotype
neourthodox	JJ	neourthodox
neovascularisation	NNN	neovascularisation
neoytterbium	NN	neoytterbium
nep	NN	nep
nepa	NN	nepa
nepenthaceae	NN	nepenthaceae
nepenthe	NN	nepenthe
nepenthean	JJ	nepenthean
nepenthes	NNS	nepenthe
neper	NN	neper
nepers	NNS	neper
nepeta	NN	nepeta
nephalist	NN	nephalist
nephalists	NNS	nephalist
nepheline	NN	nepheline
nephelines	NNS	nepheline
nephelinite	NN	nephelinite
nephelinites	NNS	nephelinite
nephelinitic	JJ	nephelinitic
nephelite	NN	nephelite
nephelites	NNS	nephelite
nephelium	NN	nephelium
nephelometer	NN	nephelometer
nephelometers	NNS	nephelometer
nephelometries	NNS	nephelometry
nephelometry	NN	nephelometry
nephew	NN	nephew
nephews	NNS	nephew
nephogram	NN	nephogram
nephograms	NNS	nephogram
nephograph	NN	nephograph
nephographs	NNS	nephograph
nephological	JJ	nephological
nephologies	NNS	nephology
nephologist	NN	nephologist
nephologists	NNS	nephologist
nephology	NNN	nephology
nephoscope	NN	nephoscope
nephoscopes	NNS	nephoscope
nephralgia	NN	nephralgia
nephralgias	NNS	nephralgia
nephralgic	JJ	nephralgic
nephrectomies	NNS	nephrectomy
nephrectomy	NN	nephrectomy
nephric	JJ	nephric
nephridial	JJ	nephridial
nephridium	NN	nephridium
nephridiums	NNS	nephridium
nephrism	NNN	nephrism
nephrisms	NNS	nephrism
nephrite	NN	nephrite
nephrites	NNS	nephrite
nephritic	JJ	nephritic
nephritides	NNS	nephritis
nephritis	NN	nephritis
nephritises	NNS	nephritis
nephrocalcinosis	NN	nephrocalcinosis
nephrocele	NN	nephrocele
nephrogenous	JJ	nephrogenous
nephrolepis	NN	nephrolepis
nephrolith	NN	nephrolith
nephrolithiasis	NN	nephrolithiasis
nephrolithic	JJ	nephrolithic
nephrolithotomy	NN	nephrolithotomy
nephrologies	NNS	nephrology
nephrologist	NN	nephrologist
nephrologists	NNS	nephrologist
nephrology	NNN	nephrology
nephron	NN	nephron
nephrons	NNS	nephron
nephropathic	JJ	nephropathic
nephropathies	NNS	nephropathy
nephropathy	NN	nephropathy
nephrops	NN	nephrops
nephropsidae	NN	nephropsidae
nephroses	NNS	nephrosis
nephrosis	NN	nephrosis
nephrostome	NN	nephrostome
nephrostomes	NNS	nephrostome
nephrostomial	JJ	nephrostomial
nephrostomous	JJ	nephrostomous
nephrotic	JJ	nephrotic
nephrotic	NN	nephrotic
nephrotics	NNS	nephrotic
nephrotome	NN	nephrotome
nephrotomies	NNS	nephrotomy
nephrotomise	NN	nephrotomise
nephrotomy	NN	nephrotomy
nephrotoxic	JJ	nephrotoxic
nephrotoxicities	NNS	nephrotoxicity
nephrotoxicity	NN	nephrotoxicity
nephthys	NN	nephthys
nephthytis	NN	nephthytis
nepidae	NN	nepidae
nepit	NN	nepit
nepits	NNS	nepit
nepman	NN	nepman
nepotic	JJ	nepotic
nepotism	NN	nepotism
nepotisms	NNS	nepotism
nepotist	NN	nepotist
nepotistic	JJ	nepotistic
nepotistical	JJ	nepotistical
nepotists	NNS	nepotist
neps	NNS	nep
neptunium	NN	neptunium
neptuniums	NNS	neptunium
neral	NN	neral
nerals	NNS	neral
nerd	NN	nerd
nerdier	JJR	nerdy
nerdiest	JJS	nerdy
nerdiness	NN	nerdiness
nerds	NNS	nerd
nerdy	JJ	nerdy
nereid	NN	nereid
nereides	NNS	nereid
nereids	NNS	nereid
nereis	NN	nereis
nereises	NNS	nereis
nergal	NN	nergal
nerine	NN	nerine
nerines	NNS	nerine
nerita	NN	nerita
neritic	JJ	neritic
neritid	NN	neritid
neritidae	NN	neritidae
neritina	NN	neritina
nerium	NN	nerium
nerk	NN	nerk
nerka	NN	nerka
nerkas	NNS	nerka
nerks	NNS	nerk
nerodia	NN	nerodia
nerol	NN	nerol
neroli	NN	neroli
nerolis	NNS	neroli
nerols	NNS	nerol
nerthus	NN	nerthus
nerts	UH	nerts
nervate	JJ	nervate
nervation	NNN	nervation
nervations	NNS	nervation
nervature	NN	nervature
nervatures	NNS	nervature
nerve	NNN	nerve
nerve	VB	nerve
nerve	VBP	nerve
nerve-racking	JJ	nerve-racking
nerve-wracking	JJ	nerve-wracking
nerved	VBD	nerve
nerved	VBN	nerve
nerveless	JJ	nerveless
nervelessly	RB	nervelessly
nervelessness	NN	nervelessness
nervelessnesses	NNS	nervelessness
nervelet	NN	nervelet
nervelets	NNS	nervelet
nerver	NN	nerver
nerveroot	NN	nerveroot
nervers	NNS	nerver
nerves	NNS	nerve
nerves	VBZ	nerve
nervi	NN	nervi
nervier	JJR	nervy
nerviest	JJS	nervy
nervily	RB	nervily
nervine	JJ	nervine
nervine	NN	nervine
nervines	NN	nervines
nervines	NNS	nervine
nerviness	NN	nerviness
nervinesses	NNS	nerviness
nervinesses	NNS	nervines
nerving	NNN	nerving
nerving	VBG	nerve
nervings	NNS	nerving
nervosities	NNS	nervosity
nervosity	NNN	nervosity
nervous	JJ	nervous
nervously	RB	nervously
nervousness	NN	nervousness
nervousnesses	NNS	nervousness
nervule	NN	nervule
nervules	NNS	nervule
nervuration	NNN	nervuration
nervurations	NNS	nervuration
nervure	NN	nervure
nervures	NNS	nervure
nervus	NN	nervus
nervy	JJ	nervy
nescience	NN	nescience
nesciences	NNS	nescience
nescient	JJ	nescient
nescient	NN	nescient
nescients	NNS	nescient
nesh	JJ	nesh
nesokia	NN	nesokia
nesosilicate	NN	nesosilicate
ness	NN	ness
nesses	NNS	ness
nest	NN	nest
nest	VB	nest
nest	VBP	nest
nestable	JJ	nestable
nested	VBD	nest
nested	VBN	nest
nester	NN	nester
nesters	NNS	nester
nesting	VBG	nest
nestle	NN	nestle
nestle	VB	nestle
nestle	VBP	nestle
nestled	JJ	nestled
nestled	VBD	nestle
nestled	VBN	nestle
nestler	NN	nestler
nestlers	NNS	nestler
nestles	NNS	nestle
nestles	VBZ	nestle
nestlike	JJ	nestlike
nestling	NNN	nestling
nestling	NNS	nestling
nestling	VBG	nestle
nestlings	NNS	nestling
nestor	NN	nestor
nestors	NNS	nestor
nests	NNS	nest
nests	VBZ	nest
nesty	JJ	nesty
net	JJ	net
net	NNN	net
net	VB	net
net	VBP	net
netback	NN	netback
netbacks	NNS	netback
netball	NN	netball
nete	NN	nete
netes	NNS	nete
netful	NN	netful
netfuls	NNS	netful
nether	JJ	nether
nethermost	DT	nethermost
netherstock	NN	netherstock
netherstocks	NNS	netherstock
netherward	JJ	netherward
netherward	NN	netherward
netherwards	NNS	netherward
netherworld	NN	netherworld
netherworlds	NNS	netherworld
netiquette	NN	netiquette
netiquettes	NNS	netiquette
netizen	NN	netizen
netizens	NNS	netizen
netkeeper	NN	netkeeper
netless	JJ	netless
netlike	JJ	netlike
netmail	VB	netmail
netmail	VBP	netmail
netman	NN	netman
netminder	NN	netminder
netminders	NNS	netminder
netop	NN	netop
netops	NNS	netop
nets	NNS	net
nets	VBZ	net
netscape	NN	netscape
netsuke	NN	netsuke
netsukes	NNS	netsuke
nett	JJ	nett
nettable	JJ	nettable
netted	VBD	net
netted	VBN	net
netter	NN	netter
netter	JJR	nett
netter	JJR	net
netters	NNS	netter
nettier	JJR	netty
nettiest	JJS	netty
netting	NN	netting
netting	VBG	net
nettings	NNS	netting
nettle	NN	nettle
nettle	VB	nettle
nettle	VBP	nettle
nettled	VBD	nettle
nettled	VBN	nettle
nettlefish	NN	nettlefish
nettlefish	NNS	nettlefish
nettlelike	JJ	nettlelike
nettler	NN	nettler
nettlers	NNS	nettler
nettles	NNS	nettle
nettles	VBZ	nettle
nettlesome	JJ	nettlesome
nettlier	JJR	nettly
nettliest	JJS	nettly
nettling	NNN	nettling
nettling	NNS	nettling
nettling	VBG	nettle
nettly	RB	nettly
netty	JJ	netty
network	NN	network
network	VB	network
network	VBP	network
networkable	JJ	networkable
networked	VBD	network
networked	VBN	network
networker	NN	networker
networkers	NNS	networker
networking	NN	networking
networking	VBG	network
networkings	NNS	networking
networklike	JJ	networklike
networks	NNS	network
networks	VBZ	network
networkwide	JJ	networkwide
neuk	NN	neuk
neuks	NNS	neuk
neum	NN	neum
neumatic	JJ	neumatic
neume	NN	neume
neumes	NNS	neume
neumic	JJ	neumic
neums	NNS	neum
neural	JJ	neural
neuralgia	NN	neuralgia
neuralgias	NNS	neuralgia
neuralgic	JJ	neuralgic
neuralgy	NN	neuralgy
neurally	RB	neurally
neuraminidase	NN	neuraminidase
neuraminidases	NNS	neuraminidase
neurasthenia	NN	neurasthenia
neurasthenias	NNS	neurasthenia
neurasthenic	JJ	neurasthenic
neurasthenic	NN	neurasthenic
neurasthenically	RB	neurasthenically
neurasthenics	NNS	neurasthenic
neuration	NNN	neuration
neurations	NNS	neuration
neuraxitis	NN	neuraxitis
neuraxon	NN	neuraxon
neuraxons	NNS	neuraxon
neurectomies	NNS	neurectomy
neurectomy	NN	neurectomy
neurilemma	NN	neurilemma
neurilemmal	JJ	neurilemmal
neurilemmas	NNS	neurilemma
neurilemmatic	JJ	neurilemmatic
neurine	NN	neurine
neurines	NNS	neurine
neurite	NN	neurite
neuritic	JJ	neuritic
neuritic	NN	neuritic
neuritics	NNS	neuritic
neuritides	NNS	neuritis
neuritis	NN	neuritis
neuritises	NNS	neuritis
neuroanatomic	JJ	neuroanatomic
neuroanatomical	JJ	neuroanatomical
neuroanatomies	NNS	neuroanatomy
neuroanatomist	NN	neuroanatomist
neuroanatomists	NNS	neuroanatomist
neuroanatomy	NN	neuroanatomy
neurobehavioural	JJ	neurobehavioural
neurobiological	JJ	neurobiological
neurobiologies	NNS	neurobiology
neurobiologist	NN	neurobiologist
neurobiologists	NNS	neurobiologist
neurobiology	NNN	neurobiology
neuroblast	NN	neuroblast
neuroblastic	JJ	neuroblastic
neuroblastoma	NN	neuroblastoma
neuroblastomas	NNS	neuroblastoma
neuroblasts	NNS	neuroblast
neurocelian	JJ	neurocelian
neurochemical	NN	neurochemical
neurochemicals	NNS	neurochemical
neurochemist	NN	neurochemist
neurochemistries	NNS	neurochemistry
neurochemistry	NN	neurochemistry
neurochemists	NNS	neurochemist
neurochip	NN	neurochip
neurochips	NNS	neurochip
neurocoele	NN	neurocoele
neurocoelian	JJ	neurocoelian
neurocomputer	NN	neurocomputer
neurocomputers	NNS	neurocomputer
neurodegeneration	NNN	neurodegeneration
neurodegenerative	JJ	neurodegenerative
neurodevelopment	NN	neurodevelopment
neurodevelopmental	JJ	neurodevelopmental
neuroembryological	NN	neuroembryological
neuroembryology	NNN	neuroembryology
neuroendocrine	JJ	neuroendocrine
neuroendocrinologies	NNS	neuroendocrinology
neuroendocrinologist	NN	neuroendocrinologist
neuroendocrinologists	NNS	neuroendocrinologist
neuroendocrinology	NNN	neuroendocrinology
neurofibril	NN	neurofibril
neurofibrils	NNS	neurofibril
neurofibroma	NN	neurofibroma
neurofibromas	NNS	neurofibroma
neurofibromatoses	NNS	neurofibromatosis
neurofibromatosis	NN	neurofibromatosis
neurogeneses	NNS	neurogenesis
neurogenesis	NN	neurogenesis
neurogenetic	NN	neurogenetic
neurogenetics	NNS	neurogenetic
neurogenic	JJ	neurogenic
neuroglia	NN	neuroglia
neurogliac	JJ	neurogliac
neurogliacyte	NN	neurogliacyte
neuroglial	JJ	neuroglial
neurogliar	JJ	neurogliar
neuroglias	NNS	neuroglia
neuroglic	JJ	neuroglic
neuroglycopenic	JJ	neuroglycopenic
neurogram	NN	neurogram
neurogrammic	JJ	neurogrammic
neurograms	NNS	neurogram
neurohormone	NN	neurohormone
neurohormones	NNS	neurohormone
neurohumor	NN	neurohumor
neurohumoral	JJ	neurohumoral
neurohumors	NNS	neurohumor
neurohypophyses	NNS	neurohypophysis
neurohypophysis	NN	neurohypophysis
neurohypophysises	NNS	neurohypophysis
neurolemma	NN	neurolemma
neurolemmas	NNS	neurolemma
neuroleptic	NN	neuroleptic
neuroleptics	NNS	neuroleptic
neurolinguist	NN	neurolinguist
neurolinguistic	NN	neurolinguistic
neurolinguistics	NNS	neurolinguistic
neurolinguists	NNS	neurolinguist
neurologic	JJ	neurologic
neurological	JJ	neurological
neurologically	RB	neurologically
neurologies	NNS	neurology
neurologist	NN	neurologist
neurologists	NNS	neurologist
neurology	NN	neurology
neurolytic	JJ	neurolytic
neuroma	NN	neuroma
neuromas	NNS	neuroma
neuromast	NN	neuromast
neuromastic	JJ	neuromastic
neuromasts	NNS	neuromast
neuromatous	JJ	neuromatous
neuromotor	JJ	neuromotor
neuromuscular	JJ	neuromuscular
neuron	JJ	neuron
neuron	NN	neuron
neuronal	JJ	neuronal
neurone	NN	neurone
neurones	NNS	neurone
neuronic	JJ	neuronic
neurons	NNS	neuron
neuropath	NN	neuropath
neuropathic	JJ	neuropathic
neuropathically	RB	neuropathically
neuropathies	NNS	neuropathy
neuropathist	NN	neuropathist
neuropathists	NNS	neuropathist
neuropathological	JJ	neuropathological
neuropathologically	RB	neuropathologically
neuropathologies	NNS	neuropathology
neuropathologist	NN	neuropathologist
neuropathologists	NNS	neuropathologist
neuropathology	NNN	neuropathology
neuropaths	NNS	neuropath
neuropathy	NN	neuropathy
neuropeptide	NN	neuropeptide
neuropeptides	NNS	neuropeptide
neuropharmacological	JJ	neuropharmacological
neuropharmacologies	NNS	neuropharmacology
neuropharmacologist	NN	neuropharmacologist
neuropharmacologists	NNS	neuropharmacologist
neuropharmacology	NNN	neuropharmacology
neurophysiologic	JJ	neurophysiologic
neurophysiological	JJ	neurophysiological
neurophysiologically	RB	neurophysiologically
neurophysiologies	NNS	neurophysiology
neurophysiologist	NN	neurophysiologist
neurophysiologists	NNS	neurophysiologist
neurophysiology	NNN	neurophysiology
neuroplasm	NN	neuroplasm
neuroplasmatic	JJ	neuroplasmatic
neuroplasmic	JJ	neuroplasmic
neuroprotective	JJ	neuroprotective
neuropsychiatric	JJ	neuropsychiatric
neuropsychiatries	NNS	neuropsychiatry
neuropsychiatrist	NN	neuropsychiatrist
neuropsychiatrists	NNS	neuropsychiatrist
neuropsychiatry	NN	neuropsychiatry
neuropsychological	JJ	neuropsychological
neuropsychologies	NNS	neuropsychology
neuropsychologist	NN	neuropsychologist
neuropsychologists	NNS	neuropsychologist
neuropsychology	NNN	neuropsychology
neuropsychopharmacology	NNN	neuropsychopharmacology
neuroptera	NN	neuroptera
neuropteran	NN	neuropteran
neuropterans	NNS	neuropteran
neuropterist	NN	neuropterist
neuropterists	NNS	neuropterist
neuropteron	NN	neuropteron
neuropterous	JJ	neuropterous
neuroradiological	JJ	neuroradiological
neuroradiologies	NNS	neuroradiology
neuroradiologist	NN	neuroradiologist
neuroradiologists	NNS	neuroradiologist
neuroradiology	NNN	neuroradiology
neurosarcoma	NN	neurosarcoma
neuroscience	NN	neuroscience
neurosciences	NNS	neuroscience
neuroscientific	JJ	neuroscientific
neuroscientist	NN	neuroscientist
neuroscientists	NNS	neuroscientist
neurosecretion	NNN	neurosecretion
neurosecretions	NNS	neurosecretion
neuroses	NNS	neurosis
neurosis	NN	neurosis
neurospora	NN	neurospora
neurosporas	NNS	neurospora
neurosurgeon	NN	neurosurgeon
neurosurgeons	NNS	neurosurgeon
neurosurgeries	NNS	neurosurgery
neurosurgery	NN	neurosurgery
neurosurgical	JJ	neurosurgical
neurosyphilis	NN	neurosyphilis
neurotic	JJ	neurotic
neurotic	NN	neurotic
neurotically	RB	neurotically
neuroticism	NNN	neuroticism
neuroticisms	NNS	neuroticism
neurotics	NNS	neurotic
neurotomies	NNS	neurotomy
neurotomy	NN	neurotomy
neurotoxic	JJ	neurotoxic
neurotoxicities	NNS	neurotoxicity
neurotoxicity	NN	neurotoxicity
neurotoxicology	NNN	neurotoxicology
neurotoxin	NN	neurotoxin
neurotoxins	NNS	neurotoxin
neurotransmission	NN	neurotransmission
neurotransmissions	NNS	neurotransmission
neurotransmitter	NN	neurotransmitter
neurotransmitters	NNS	neurotransmitter
neurotrichus	NN	neurotrichus
neurotrophic	JJ	neurotrophic
neurotrophy	NN	neurotrophy
neurotropic	JJ	neurotropic
neurotropism	NNN	neurotropism
neurotropisms	NNS	neurotropism
neurovascular	JJ	neurovascular
neurula	NN	neurula
neurulas	NNS	neurula
neurulation	NNN	neurulation
neurulations	NNS	neurulation
neustic	JJ	neustic
neuston	NN	neuston
neustonic	JJ	neustonic
neustons	NNS	neuston
neut	NN	neut
neuter	JJ	neuter
neuter	NNN	neuter
neuter	VB	neuter
neuter	VBG	neuter
neuter	VBP	neuter
neutered	JJ	neutered
neutered	VBD	neuter
neutered	VBN	neuter
neutering	NNN	neutering
neutering	VBG	neuter
neuters	NNS	neuter
neuters	VBZ	neuter
neutral	JJ	neutral
neutral	NN	neutral
neutralisation	NNN	neutralisation
neutralise	NN	neutralise
neutralise	VB	neutralise
neutralise	VBP	neutralise
neutralised	VBD	neutralise
neutralised	VBN	neutralise
neutraliser	NN	neutraliser
neutralisers	NNS	neutraliser
neutralises	VBZ	neutralise
neutralising	VBG	neutralise
neutralism	NN	neutralism
neutralisms	NNS	neutralism
neutralist	NN	neutralist
neutralists	NNS	neutralist
neutralities	NNS	neutrality
neutrality	NN	neutrality
neutralization	NN	neutralization
neutralizations	NNS	neutralization
neutralize	VB	neutralize
neutralize	VBP	neutralize
neutralized	VBD	neutralize
neutralized	VBN	neutralize
neutralizer	NN	neutralizer
neutralizers	NNS	neutralizer
neutralizes	VBZ	neutralize
neutralizing	VBG	neutralize
neutrally	RB	neutrally
neutralness	NN	neutralness
neutralnesses	NNS	neutralness
neutrals	NNS	neutral
neutretto	NN	neutretto
neutrettos	NNS	neutretto
neutrino	NN	neutrino
neutrinoless	JJ	neutrinoless
neutrinos	NNS	neutrino
neutron	NN	neutron
neutrons	NNS	neutron
neutropenia	NN	neutropenia
neutropenic	JJ	neutropenic
neutrophil	JJ	neutrophil
neutrophil	NN	neutrophil
neutrophile	NN	neutrophile
neutrophiles	NNS	neutrophile
neutrophilic	JJ	neutrophilic
neutrophils	NNS	neutrophil
neutrosphere	NN	neutrosphere
nevadan	NN	nevadan
neve	NN	neve
nevelling	NN	nevelling
nevelling	NNS	nevelling
never	RB	never
never	UH	never
never-ending	JJ	never-ending
never-never	JJ	never-never
never-never	NN	never-never
never-say-die	JJ	never-say-die
nevermind	NN	nevermind
neverminds	NNS	nevermind
nevermore	RB	nevermore
nevertheless	CC	nevertheless
nevertheless	RB	nevertheless
neves	NNS	neve
neves	NNS	nef
nevi	NNS	nevus
nevirapine	NN	nevirapine
nevoid	JJ	nevoid
nevus	NN	nevus
new	JJ	new
new-car	JJ	new-car
new-fashioned	JJ	new-fashioned
new-made	JJ	new-made
new-model	JJ	new-model
new-mown	JJ	new-mown
new-rich	JJ	new-rich
new-rich	NN	new-rich
new-sprung	JJ	new-sprung
newari	NN	newari
newbie	NN	newbie
newbies	NNS	newbie
newborn	JJ	newborn
newborn	NN	newborn
newborns	NNS	newborn
newcomer	NN	newcomer
newcomers	NNS	newcomer
newel	NN	newel
newels	NNS	newel
newer	JJR	new
newest	JJS	new
newfangled	JJ	newfangled
newfangledly	RB	newfangledly
newfangledness	NN	newfangledness
newfanglednesses	NNS	newfangledness
newfound	JJ	newfound
newground	NN	newground
newie	NN	newie
newies	NNS	newie
newish	JJ	newish
newline	NN	newline
newlines	NNS	newline
newly	RB	newly
newlywed	NN	newlywed
newlyweds	NNS	newlywed
newmarket	NN	newmarket
newmarkets	NNS	newmarket
newmusic	JJ	newmusic
newness	NN	newness
newnesses	NNS	newness
news	NN	news
newsagent	NN	newsagent
newsagents	NNS	newsagent
newsbeat	NN	newsbeat
newsbeats	NNS	newsbeat
newsboard	NN	newsboard
newsboy	NN	newsboy
newsboys	NNS	newsboy
newsbreak	NN	newsbreak
newsbreaks	NNS	newsbreak
newscast	NN	newscast
newscaster	NN	newscaster
newscasters	NNS	newscaster
newscasting	NN	newscasting
newscastings	NNS	newscasting
newscasts	NNS	newscast
newsdealer	NN	newsdealer
newsdealers	NNS	newsdealer
newsdesk	NN	newsdesk
newsdesks	NNS	newsdesk
newses	NNS	news
newsflash	NN	newsflash
newsflashes	NNS	newsflash
newsgathering	NN	newsgathering
newsgatherings	NNS	newsgathering
newsgirl	NN	newsgirl
newsgirls	NNS	newsgirl
newsgroup	NN	newsgroup
newsgroups	NNS	newsgroup
newshawk	NN	newshawk
newshawks	NNS	newshawk
newshen	NN	newshen
newshound	NN	newshound
newshounds	NNS	newshound
newsie	JJ	newsie
newsie	NN	newsie
newsier	JJR	newsie
newsier	JJR	newsy
newsies	NNS	newsie
newsiest	JJS	newsie
newsiest	JJS	newsy
newsiness	NN	newsiness
newsinesses	NNS	newsiness
newsless	JJ	newsless
newslessness	NN	newslessness
newsletter	NN	newsletter
newsletters	NNS	newsletter
newsmagazine	NN	newsmagazine
newsmagazines	NNS	newsmagazine
newsmaker	NN	newsmaker
newsmakers	NNS	newsmaker
newsman	NN	newsman
newsmen	NNS	newsman
newsmonger	NN	newsmonger
newsmongers	NNS	newsmonger
newspaper	NNN	newspaper
newspaperdom	NN	newspaperdom
newspapering	NN	newspapering
newspaperings	NNS	newspapering
newspaperish	JJ	newspaperish
newspaperman	NN	newspaperman
newspapermen	NNS	newspaperman
newspapers	NNS	newspaper
newspaperwoman	NN	newspaperwoman
newspaperwomen	NNS	newspaperwoman
newspeak	NN	newspeak
newspeaks	NNS	newspeak
newspeople	NNS	newsperson
newsperson	NN	newsperson
newspersons	NNS	newsperson
newsprint	NN	newsprint
newsprints	NNS	newsprint
newsreader	NN	newsreader
newsreaders	NNS	newsreader
newsreel	NNN	newsreel
newsreels	NNS	newsreel
newsroom	NN	newsroom
newsrooms	NNS	newsroom
newssheet	NN	newssheet
newssheets	NNS	newssheet
newsstand	NN	newsstand
newsstands	NNS	newsstand
newsvendor	NN	newsvendor
sissonne	NN	sissonne
sissoo	NN	sissoo
sissoos	NNS	sissoo
sissu	NN	sissu
sissy	JJ	sissy
sissy	NN	sissy
sissyish	JJ	sissyish
sissyness	NN	sissyness
sissynesses	NNS	sissyness
sister	JJ	sister
sister	NN	sister
sister-in-law	NN	sister-in-law
sisterhood	NN	sisterhood
sisterhoods	NNS	sisterhood
sisterless	JJ	sisterless
sisterlike	JJ	sisterlike
sisterliness	NN	sisterliness
sisterlinesses	NNS	sisterliness
sisterly	RB	sisterly
sisters	NNS	sister
sisters-in-law	NNS	sister-in-law
sistership	NN	sistership
sistroid	JJ	sistroid
sistrum	NN	sistrum
sistrums	NNS	sistrum
sistrurus	NN	sistrurus
sisyridae	NN	sisyridae
sisyrinchium	NN	sisyrinchium
sit	VB	sit
sit	VBP	sit
sit-down	NNN	sit-down
sit-up	NN	sit-up
sit-upon	NN	sit-upon
sitar	NN	sitar
sitarist	NN	sitarist
sitarists	NNS	sitarist
sitars	NNS	sitar
sitatunga	NN	sitatunga
sitatungas	NNS	sitatunga
sitcom	NN	sitcom
sitcoms	NNS	sitcom
sitdown	NN	sitdown
sitdowns	NNS	sitdown
site	NN	site
site	VB	site
site	VBP	site
site-specific	JJ	site-specific
sited	VBD	site
sited	VBN	site
sitella	NN	sitella
sitellas	NNS	sitella
sites	NNS	site
sites	VBZ	site
sitewide	JJ	sitewide
sitfast	NN	sitfast
sitfasts	NNS	sitfast
sith	CC	sith
sith	RB	sith
sithe	NN	sithe
sithen	NN	sithen
sithens	NNS	sithen
sithes	NNS	sithe
siting	VBG	site
sitologies	NNS	sitology
sitology	NNN	sitology
sitomania	NN	sitomania
sitomanias	NNS	sitomania
sitophylus	NN	sitophylus
sitosterol	NN	sitosterol
sitosterols	NNS	sitosterol
sitotroga	NN	sitotroga
sitrep	NN	sitrep
sitreps	NNS	sitrep
sits	VBZ	sit
sitta	NN	sitta
sitter	NN	sitter
sitters	NNS	sitter